kraj,month,year,uchazeciOZamestnaniUoZ,uchazeciOZamestnaniUoZZeny,uchazeciOZamestnaniUoZMuzi,noveHlaseniUchazeci,noveHlasenaAUvolnenaVPM,obsazenaAZrusenaVPM,absolventiSkolAMladistvi
PHA,1,2008,17818,9286,8532,4297,7685,8186,890
STC,1,2008,1661,889,772,496,247,203,123
STC,1,2008,1682,934,748,413,335,433,105
STC,1,2008,5311,2849,2462,901,439,427,363
STC,1,2008,3051,1680,1371,671,566,456,258
STC,1,2008,2652,1449,1203,540,618,404,125
STC,1,2008,3150,1874,1276,554,341,173,216
STC,1,2008,1864,1077,787,387,1099,1371,97
STC,1,2008,3076,1696,1380,507,748,789,195
STC,1,2008,1352,752,600,383,928,625,76
STC,1,2008,1128,629,499,333,211,244,69
STC,1,2008,3773,1848,1925,770,272,176,206
STC,1,2008,1552,871,681,304,119,45,120
JHC,1,2008,3761,1993,1768,943,593,494,294
JHC,1,2008,2620,1352,1268,665,312,214,153
JHC,1,2008,2617,1448,1169,594,233,187,150
JHC,1,2008,2135,1140,995,507,365,444,107
JHC,1,2008,1306,637,669,357,145,200,103
JHC,1,2008,2248,1179,1069,433,189,223,152
JHC,1,2008,2750,1479,1271,605,490,618,204
PLK,1,2008,1600,896,704,359,107,206,65
PLK,1,2008,3119,1605,1514,690,286,274,161
PLK,1,2008,4147,2254,1893,926,2336,1949,254
PLK,1,2008,1087,579,508,261,159,91,64
PLK,1,2008,1917,1071,846,421,182,165,149
PLK,1,2008,1086,630,456,222,417,473,69
PLK,1,2008,2135,1001,1134,392,186,195,116
KVK,1,2008,3583,1666,1917,803,238,123,181
KVK,1,2008,5349,2640,2709,811,814,246,303
KVK,1,2008,4693,2339,2354,796,125,168,279
ULK,1,2008,8892,4558,4334,1252,402,365,543
ULK,1,2008,6900,3638,3262,997,280,356,363
ULK,1,2008,5547,2886,2661,876,524,658,313
ULK,1,2008,4852,2517,2335,684,250,339,224
ULK,1,2008,9682,5233,4449,1068,293,221,516
ULK,1,2008,7607,4355,3252,950,212,219,533
ULK,1,2008,6972,3635,3337,820,530,302,393
LBK,1,2008,3961,2179,1782,698,277,326,254
LBK,1,2008,2754,1579,1175,503,253,160,203
LBK,1,2008,5830,3125,2705,1137,804,825,325
LBK,1,2008,2350,1233,1117,475,202,204,153
HKK,1,2008,3847,2016,1831,844,1199,436,239
HKK,1,2008,2586,1343,1243,498,115,64,159
HKK,1,2008,2828,1401,1427,678,328,347,208
HKK,1,2008,1260,720,540,376,183,243,67
HKK,1,2008,4297,2184,2113,696,475,461,270
PAK,1,2008,3527,1829,1698,764,296,320,235
PAK,1,2008,3752,1992,1760,865,2440,1894,330
PAK,1,2008,4912,2450,2462,862,371,390,251
PAK,1,2008,4004,2093,1911,805,936,974,284
VYS,1,2008,2413,1341,1072,511,210,281,169
VYS,1,2008,3564,1784,1780,770,483,413,308
VYS,1,2008,1514,715,799,408,1247,1546,98
VYS,1,2008,5532,2992,2540,962,243,225,380
VYS,1,2008,4083,2056,2027,635,316,252,307
JHM,1,2008,3308,1903,1405,541,657,565,196
JHM,1,2008,13137,7224,5913,1771,2477,1250,731
JHM,1,2008,5077,2901,2176,987,389,375,335
JHM,1,2008,4962,2352,2610,881,286,311,387
JHM,1,2008,9052,4498,4554,1188,399,300,583
JHM,1,2008,2522,1359,1163,584,191,294,164
JHM,1,2008,7246,3795,3451,1183,512,380,420
OLK,1,2008,2841,1392,1449,583,152,117,130
OLK,1,2008,7503,3921,3582,1744,1507,1582,460
OLK,1,2008,2731,1628,1103,541,283,326,148
OLK,1,2008,6237,3244,2993,973,291,270,359
OLK,1,2008,5457,2869,2588,891,244,207,356
ZLK,1,2008,4510,2444,2066,725,372,196,320
ZLK,1,2008,4577,2491,2086,807,259,382,240
ZLK,1,2008,5968,2978,2990,840,433,422,383
ZLK,1,2008,5684,3347,2337,1011,624,507,397
MSK,1,2008,6009,3213,2796,851,418,337,299
MSK,1,2008,8838,4540,4298,1329,690,587,530
MSK,1,2008,20101,10539,9562,1931,1086,662,1049
MSK,1,2008,5267,2641,2626,966,560,411,309
MSK,1,2008,8023,4112,3911,1218,382,331,536
MSK,1,2008,17805,9023,8782,2134,1522,1098,855
PHA,2,2008,17510,9091,8419,3166,7833,7009,886
STC,2,2008,1629,866,763,315,245,259,112
STC,2,2008,1611,928,683,243,371,468,103
STC,2,2008,5158,2763,2395,640,420,424,353
STC,2,2008,2927,1606,1321,423,543,411,243
STC,2,2008,2536,1395,1141,263,980,341,120
STC,2,2008,3109,1846,1263,393,344,210,226
STC,2,2008,1826,1065,761,287,297,334,107
STC,2,2008,2994,1646,1348,358,623,543,185
STC,2,2008,1303,711,592,254,831,821,60
STC,2,2008,1139,641,498,268,207,87,72
STC,2,2008,3713,1815,1898,481,420,356,197
STC,2,2008,1544,858,686,206,139,147,119
JHC,2,2008,3662,1951,1711,666,529,635,293
JHC,2,2008,2547,1314,1233,333,102,198,162
JHC,2,2008,2528,1420,1108,296,124,176,152
JHC,2,2008,2041,1093,948,309,446,349,114
JHC,2,2008,1317,634,683,234,153,211,102
JHC,2,2008,2169,1151,1018,223,286,215,142
JHC,2,2008,2671,1437,1234,363,550,325,203
PLK,2,2008,1507,863,644,187,118,127,60
PLK,2,2008,3051,1566,1485,405,306,296,163
PLK,2,2008,4025,2193,1832,665,3543,2956,245
PLK,2,2008,1037,536,501,174,129,210,54
PLK,2,2008,1834,1040,794,233,143,104,145
PLK,2,2008,1060,620,440,140,238,313,66
PLK,2,2008,2131,992,1139,233,189,329,119
KVK,2,2008,3448,1630,1818,464,475,584,180
KVK,2,2008,5231,2575,2656,502,428,337,292
KVK,2,2008,4657,2334,2323,510,130,110,271
ULK,2,2008,8670,4469,4201,636,361,296,526
ULK,2,2008,6760,3554,3206,697,286,370,336
ULK,2,2008,5361,2819,2542,521,561,298,317
ULK,2,2008,4791,2505,2286,495,278,247,233
ULK,2,2008,9397,5093,4304,599,213,284,524
ULK,2,2008,7353,4227,3126,581,217,265,494
ULK,2,2008,6903,3605,3298,637,384,478,390
LBK,2,2008,3914,2107,1807,505,413,291,258
LBK,2,2008,2693,1531,1162,385,194,171,206
LBK,2,2008,5740,3124,2616,913,814,1001,330
LBK,2,2008,2298,1227,1071,250,191,204,156
HKK,2,2008,3701,1972,1729,522,686,907,231
HKK,2,2008,2467,1313,1154,272,187,140,153
HKK,2,2008,2687,1346,1341,393,224,242,212
HKK,2,2008,1218,711,507,235,153,202,76
HKK,2,2008,4177,2094,2083,451,409,525,292
PAK,2,2008,3383,1769,1614,368,406,280,205
PAK,2,2008,3569,1905,1664,502,914,341,301
PAK,2,2008,4783,2408,2375,434,309,285,252
PAK,2,2008,3885,2046,1839,456,780,581,278
VYS,2,2008,2314,1301,1013,275,546,368,162
VYS,2,2008,3440,1705,1735,412,412,477,288
VYS,2,2008,1498,722,776,212,231,248,89
VYS,2,2008,5364,2929,2435,471,239,157,377
VYS,2,2008,3951,2002,1949,398,252,441,298
JHM,2,2008,3232,1868,1364,372,365,446,191
JHM,2,2008,12674,6966,5708,1389,2206,852,694
JHM,2,2008,4905,2813,2092,603,407,459,298
JHM,2,2008,4686,2294,2392,477,420,358,376
JHM,2,2008,8889,4422,4467,794,504,281,613
JHM,2,2008,2445,1321,1124,336,212,170,159
JHM,2,2008,7203,3780,3423,663,688,714,422
OLK,2,2008,2765,1339,1426,246,87,117,121
OLK,2,2008,7356,3800,3556,954,1048,882,474
OLK,2,2008,2697,1587,1110,352,203,320,138
OLK,2,2008,5986,3152,2834,516,326,302,339
OLK,2,2008,5315,2777,2538,501,358,242,349
ZLK,2,2008,4411,2401,2010,453,322,259,299
ZLK,2,2008,4490,2433,2057,495,195,297,243
ZLK,2,2008,5853,2921,2932,528,299,407,358
ZLK,2,2008,5527,3235,2292,676,634,677,408
MSK,2,2008,5848,3144,2704,526,241,265,289
MSK,2,2008,8476,4388,4088,855,784,655,518
MSK,2,2008,19731,10432,9299,1404,615,728,1014
MSK,2,2008,5044,2558,2486,607,458,495,294
MSK,2,2008,7831,4000,3831,759,352,376,550
MSK,2,2008,17437,8873,8564,1642,935,768,889
PHA,3,2008,17113,8791,8322,3032,7914,4542,839
STC,3,2008,1494,799,695,290,284,365,114
STC,3,2008,1583,903,680,276,570,480,105
STC,3,2008,4913,2681,2232,552,193,479,328
STC,3,2008,2728,1518,1210,440,357,489,220
STC,3,2008,2332,1307,1025,250,209,266,113
STC,3,2008,2934,1766,1168,345,350,378,203
STC,3,2008,1761,1019,742,262,232,263,105
STC,3,2008,2794,1547,1247,332,470,462,174
STC,3,2008,1241,669,572,284,830,1048,61
STC,3,2008,1105,613,492,197,299,332,59
STC,3,2008,3368,1708,1660,412,335,340,186
STC,3,2008,1476,818,658,219,229,247,110
JHC,3,2008,3472,1902,1570,619,506,365,266
JHC,3,2008,2351,1242,1109,296,351,215,152
JHC,3,2008,2162,1277,885,286,244,155,143
JHC,3,2008,1875,1033,842,289,197,227,112
JHC,3,2008,1274,638,636,228,159,76,100
JHC,3,2008,2017,1117,900,236,252,202,132
JHC,3,2008,2494,1386,1108,346,415,303,201
PLK,3,2008,1428,831,597,206,158,98,63
PLK,3,2008,2805,1483,1322,353,120,210,148
PLK,3,2008,3816,2141,1675,629,1150,1863,231
PLK,3,2008,1004,532,472,196,80,63,60
PLK,3,2008,1667,967,700,195,100,154,131
PLK,3,2008,971,560,411,154,223,230,67
PLK,3,2008,2052,996,1056,283,172,180,133
KVK,3,2008,3177,1503,1674,416,448,411,172
KVK,3,2008,4928,2423,2505,430,339,605,287
KVK,3,2008,4419,2218,2201,488,252,100,262
ULK,3,2008,8355,4334,4021,699,220,210,487
ULK,3,2008,6586,3461,3125,710,346,365,344
ULK,3,2008,5046,2689,2357,524,357,477,280
ULK,3,2008,4502,2376,2126,438,172,226,220
ULK,3,2008,8969,4882,4087,599,204,354,488
ULK,3,2008,7106,4108,2998,605,238,203,484
ULK,3,2008,6690,3525,3165,512,264,262,369
LBK,3,2008,3708,2025,1683,436,307,198,245
LBK,3,2008,2678,1500,1178,378,403,387,201
LBK,3,2008,5616,3073,2543,764,822,899,315
LBK,3,2008,2241,1226,1015,278,157,169,150
HKK,3,2008,3464,1858,1606,497,626,540,210
HKK,3,2008,2353,1276,1077,301,160,153,153
HKK,3,2008,2481,1262,1219,361,438,183,182
HKK,3,2008,1163,680,483,231,210,178,65
HKK,3,2008,3989,2009,1980,461,411,452,271
PAK,3,2008,3062,1670,1392,382,393,215,188
PAK,3,2008,3390,1829,1561,502,582,1941,290
PAK,3,2008,4402,2261,2141,398,221,269,252
PAK,3,2008,3609,1945,1664,439,667,768,246
VYS,3,2008,2171,1263,908,292,293,332,160
VYS,3,2008,3185,1627,1558,405,457,584,266
VYS,3,2008,1350,683,667,196,331,280,72
VYS,3,2008,4944,2778,2166,428,168,149,340
VYS,3,2008,3778,1946,1832,397,279,237,288
JHM,3,2008,3064,1767,1297,349,370,540,181
JHM,3,2008,12438,6800,5638,1298,2217,3068,658
JHM,3,2008,4655,2706,1949,589,516,358,288
JHM,3,2008,4310,2191,2119,534,436,433,333
JHM,3,2008,8466,4252,4214,848,313,483,557
JHM,3,2008,2214,1216,998,305,118,147,146
JHM,3,2008,6523,3548,2975,502,196,271,397
OLK,3,2008,2487,1262,1225,228,59,67,122
OLK,3,2008,6900,3640,3260,902,958,1060,467
OLK,3,2008,2553,1525,1028,369,329,322,136
OLK,3,2008,5591,3014,2577,496,364,308,309
OLK,3,2008,4992,2648,2344,489,431,304,328
ZLK,3,2008,4207,2323,1884,419,209,263,274
ZLK,3,2008,4257,2361,1896,477,371,134,228
ZLK,3,2008,5568,2816,2752,500,374,306,337
ZLK,3,2008,5210,3088,2122,631,518,305,386
MSK,3,2008,5526,2992,2534,498,207,203,273
MSK,3,2008,7842,4153,3689,846,539,542,523
MSK,3,2008,19199,10222,8977,1304,618,720,994
MSK,3,2008,4704,2457,2247,534,512,436,277
MSK,3,2008,7250,3750,3500,587,277,270,520
MSK,3,2008,16749,8622,8127,1552,1610,1004,915
PHA,4,2008,16538,8557,7981,3340,8054,7971,828
STC,4,2008,1343,746,597,343,482,220,94
STC,4,2008,1524,859,665,270,524,401,104
STC,4,2008,4778,2655,2123,662,470,237,322
STC,4,2008,2565,1431,1134,472,520,523,198
STC,4,2008,2076,1200,876,311,1394,1012,109
STC,4,2008,2757,1691,1066,364,498,296,183
STC,4,2008,1738,1021,717,320,1524,2576,96
STC,4,2008,2637,1466,1171,421,724,601,169
STC,4,2008,1180,644,536,271,825,1949,55
STC,4,2008,1019,576,443,240,179,457,53
STC,4,2008,3125,1616,1509,451,291,299,159
STC,4,2008,1308,756,552,217,138,180,93
JHC,4,2008,3339,1839,1500,703,526,487,254
JHC,4,2008,2084,1122,962,305,222,333,122
JHC,4,2008,1830,1127,703,284,248,216,121
JHC,4,2008,1606,929,677,269,282,258,111
JHC,4,2008,1190,629,561,244,143,162,94
JHC,4,2008,1927,1081,846,258,184,193,125
JHC,4,2008,2259,1299,960,424,453,437,180
PLK,4,2008,1346,818,528,200,271,144,62
PLK,4,2008,2601,1427,1174,394,183,212,148
PLK,4,2008,3686,2105,1581,725,2445,2182,231
PLK,4,2008,926,501,425,172,167,127,52
PLK,4,2008,1565,921,644,240,188,261,126
PLK,4,2008,965,576,389,161,120,306,68
PLK,4,2008,1909,971,938,247,215,230,127
KVK,4,2008,3025,1467,1558,449,274,504,170
KVK,4,2008,4655,2302,2353,495,334,343,250
KVK,4,2008,4183,2145,2038,526,222,169,240
ULK,4,2008,7951,4170,3781,712,231,321,462
ULK,4,2008,6273,3374,2899,761,363,259,309
ULK,4,2008,4642,2535,2107,601,581,579,268
ULK,4,2008,4231,2260,1971,488,209,249,206
ULK,4,2008,8485,4631,3854,614,223,289,454
ULK,4,2008,6794,3952,2842,698,224,224,431
ULK,4,2008,6483,3463,3020,773,339,462,376
LBK,4,2008,3539,1953,1586,519,524,327,258
LBK,4,2008,2656,1488,1168,439,199,303,199
LBK,4,2008,5515,3056,2459,916,705,855,327
LBK,4,2008,2242,1250,992,390,177,250,143
HKK,4,2008,3235,1804,1431,530,748,656,201
HKK,4,2008,2155,1209,946,303,227,113,136
HKK,4,2008,2233,1192,1041,434,312,358,163
HKK,4,2008,1094,670,424,299,321,177,73
HKK,4,2008,3791,1939,1852,645,449,355,249
PAK,4,2008,2715,1583,1132,394,234,159,167
PAK,4,2008,3130,1705,1425,518,1717,1599,254
PAK,4,2008,4029,2177,1852,452,294,243,209
PAK,4,2008,3427,1913,1514,532,868,958,206
VYS,4,2008,2010,1226,784,261,167,230,141
VYS,4,2008,2813,1515,1298,401,484,434,244
VYS,4,2008,1204,657,547,284,155,356,68
VYS,4,2008,4428,2581,1847,501,155,166,309
VYS,4,2008,3547,1914,1633,457,355,261,276
JHM,4,2008,2907,1734,1173,408,412,366,166
JHM,4,2008,12034,6664,5370,1452,2076,1140,625
JHM,4,2008,4363,2585,1778,597,317,254,272
JHM,4,2008,3857,2015,1842,584,508,519,289
JHM,4,2008,8061,4197,3864,922,314,379,524
JHM,4,2008,2010,1155,855,302,212,159,125
JHM,4,2008,5695,3224,2471,556,384,366,360
OLK,4,2008,2174,1163,1011,268,48,37,113
OLK,4,2008,6523,3562,2961,1110,1289,1201,448
OLK,4,2008,2379,1458,921,367,300,273,136
OLK,4,2008,5308,2944,2364,583,279,332,293
OLK,4,2008,4575,2502,2073,555,317,285,305
ZLK,4,2008,3840,2185,1655,400,285,167,249
ZLK,4,2008,3931,2270,1661,490,341,340,211
ZLK,4,2008,5280,2745,2535,656,712,648,332
ZLK,4,2008,4952,2956,1996,707,706,672,354
MSK,4,2008,5016,2821,2195,537,285,260,252
MSK,4,2008,7263,3933,3330,935,677,553,460
MSK,4,2008,18496,9967,8529,1413,741,580,952
MSK,4,2008,4313,2333,1980,574,516,424,261
MSK,4,2008,6766,3604,3162,732,292,265,478
MSK,4,2008,16069,8338,7731,1667,1369,1096,866
PHA,5,2008,15974,8319,7655,2676,7406,9488,721
STC,5,2008,1268,721,547,265,199,258,82
STC,5,2008,1485,839,646,239,375,386,86
STC,5,2008,4711,2636,2075,603,333,526,277
STC,5,2008,2468,1399,1069,435,508,407,163
STC,5,2008,1974,1184,790,298,625,429,102
STC,5,2008,2707,1658,1049,342,378,365,160
STC,5,2008,1674,984,690,270,1065,896,80
STC,5,2008,2551,1434,1117,338,391,593,143
STC,5,2008,1150,633,517,260,400,450,51
STC,5,2008,971,552,419,199,151,76,54
STC,5,2008,3047,1560,1487,440,365,301,152
STC,5,2008,1257,739,518,213,106,119,86
JHC,5,2008,3241,1813,1428,580,505,542,227
JHC,5,2008,1835,1007,828,228,193,118,103
JHC,5,2008,1649,1020,629,225,254,258,98
JHC,5,2008,1437,844,593,209,376,289,79
JHC,5,2008,1064,586,478,150,97,94,71
JHC,5,2008,1888,1074,814,258,229,221,106
JHC,5,2008,2142,1237,905,360,336,517,156
PLK,5,2008,1286,794,492,173,163,307,51
PLK,5,2008,2381,1319,1062,313,321,209,120
PLK,5,2008,3594,2041,1553,626,2000,1276,201
PLK,5,2008,868,488,380,163,70,307,47
PLK,5,2008,1552,936,616,219,315,304,107
PLK,5,2008,947,568,379,138,138,88,73
PLK,5,2008,1832,936,896,225,115,136,113
KVK,5,2008,2897,1437,1460,398,214,367,161
KVK,5,2008,4532,2278,2254,449,399,292,217
KVK,5,2008,4042,2082,1960,493,226,286,238
ULK,5,2008,7633,4029,3604,683,196,158,418
ULK,5,2008,5861,3230,2631,664,358,200,261
ULK,5,2008,4390,2441,1949,467,408,428,239
ULK,5,2008,4075,2175,1900,380,302,227,172
ULK,5,2008,8163,4452,3711,643,214,390,406
ULK,5,2008,6554,3807,2747,533,256,206,398
ULK,5,2008,6300,3375,2925,578,261,326,360
LBK,5,2008,3405,1887,1518,431,332,325,222
LBK,5,2008,2589,1470,1119,375,141,105,187
LBK,5,2008,5431,3022,2409,867,807,730,313
LBK,5,2008,2181,1255,926,308,107,109,125
HKK,5,2008,3123,1759,1364,458,722,671,177
HKK,5,2008,2100,1201,899,293,149,115,125
HKK,5,2008,2043,1132,911,349,351,251,144
HKK,5,2008,1000,610,390,193,167,250,64
HKK,5,2008,3568,1889,1679,589,298,330,207
PAK,5,2008,2558,1536,1022,365,269,184,140
PAK,5,2008,3005,1658,1347,488,549,353,255
PAK,5,2008,3858,2133,1725,398,222,195,187
PAK,5,2008,3331,1899,1432,449,735,831,164
VYS,5,2008,1931,1187,744,230,188,234,117
VYS,5,2008,2697,1463,1234,373,443,415,217
VYS,5,2008,1108,637,471,184,164,119,55
VYS,5,2008,4170,2490,1680,370,238,268,267
VYS,5,2008,3405,1871,1534,374,257,222,248
JHM,5,2008,2880,1713,1167,388,248,333,133
JHM,5,2008,11755,6545,5210,1290,2060,1738,596
JHM,5,2008,4192,2514,1678,549,690,168,233
JHM,5,2008,3523,1871,1652,452,323,375,237
JHM,5,2008,7595,4011,3584,652,354,356,436
JHM,5,2008,1892,1107,785,287,215,164,102
JHM,5,2008,5255,3009,2246,587,463,403,300
OLK,5,2008,1990,1104,886,211,53,79,95
OLK,5,2008,6209,3429,2780,851,1180,1122,398
OLK,5,2008,2247,1411,836,320,255,176,105
OLK,5,2008,4979,2786,2193,460,343,405,254
OLK,5,2008,4343,2440,1903,472,217,327,262
ZLK,5,2008,3675,2099,1576,408,199,346,232
ZLK,5,2008,3848,2283,1565,465,286,151,191
ZLK,5,2008,4938,2607,2331,436,479,395,287
ZLK,5,2008,4708,2794,1914,538,503,575,296
MSK,5,2008,4817,2724,2093,496,190,176,226
MSK,5,2008,6835,3777,3058,808,529,641,378
MSK,5,2008,17955,9725,8230,1255,544,538,817
MSK,5,2008,4063,2201,1862,508,376,531,202
MSK,5,2008,6360,3436,2924,547,304,294,411
MSK,5,2008,15545,8146,7399,1349,909,1190,769
PHA,6,2008,15866,8368,7498,2918,6693,7332,624
STC,6,2008,1284,734,550,294,207,161,77
STC,6,2008,1512,852,660,247,353,266,77
STC,6,2008,4660,2645,2015,637,298,281,272
STC,6,2008,2462,1415,1047,407,358,375,150
STC,6,2008,1958,1197,761,296,151,401,100
STC,6,2008,2675,1649,1026,371,394,177,152
STC,6,2008,1710,1006,704,307,2219,1921,96
STC,6,2008,2559,1435,1124,383,444,519,133
STC,6,2008,1167,656,511,260,737,903,50
STC,6,2008,970,576,394,216,105,165,39
STC,6,2008,3045,1600,1445,474,309,385,156
STC,6,2008,1263,743,520,224,246,122,85
JHC,6,2008,3154,1788,1366,595,467,493,232
JHC,6,2008,1821,997,824,303,213,308,102
JHC,6,2008,1495,919,576,268,118,165,97
JHC,6,2008,1401,813,588,278,278,265,95
JHC,6,2008,1020,581,439,191,92,147,59
JHC,6,2008,1881,1078,803,262,301,269,92
JHC,6,2008,2179,1292,887,403,399,456,141
PLK,6,2008,1302,806,496,209,116,148,57
PLK,6,2008,2368,1349,1019,368,323,390,124
PLK,6,2008,3596,2098,1498,669,1270,1615,202
PLK,6,2008,867,492,375,177,76,106,44
PLK,6,2008,1533,945,588,227,166,176,110
PLK,6,2008,962,582,380,136,149,153,64
PLK,6,2008,1865,952,913,271,129,130,106
KVK,6,2008,2837,1394,1443,411,298,226,152
KVK,6,2008,4441,2228,2213,455,419,471,226
KVK,6,2008,3939,2075,1864,451,155,167,218
ULK,6,2008,7425,3949,3476,702,215,232,351
ULK,6,2008,5615,3119,2496,725,364,289,231
ULK,6,2008,4344,2460,1884,577,539,573,219
ULK,6,2008,3928,2099,1829,434,253,353,178
ULK,6,2008,7937,4312,3625,611,240,171,356
ULK,6,2008,6359,3728,2631,612,319,257,355
ULK,6,2008,6164,3374,2790,685,306,310,342
LBK,6,2008,3339,1848,1491,439,214,284,183
LBK,6,2008,2615,1499,1116,417,238,152,163
LBK,6,2008,5446,3008,2438,817,899,776,305
LBK,6,2008,2154,1266,888,295,132,182,115
HKK,6,2008,3177,1807,1370,570,766,614,172
HKK,6,2008,2034,1172,862,306,145,150,108
HKK,6,2008,2019,1130,889,392,153,202,129
HKK,6,2008,992,622,370,236,245,173,59
HKK,6,2008,3493,1875,1618,550,430,276,176
PAK,6,2008,2529,1546,983,401,260,319,128
PAK,6,2008,2989,1659,1330,575,724,448,257
PAK,6,2008,3837,2170,1667,413,234,303,176
PAK,6,2008,3308,1892,1416,512,836,796,151
VYS,6,2008,1935,1201,734,288,221,406,108
VYS,6,2008,2763,1486,1277,424,355,355,176
VYS,6,2008,1139,674,465,240,289,379,52
VYS,6,2008,4141,2504,1637,524,122,132,230
VYS,6,2008,3390,1877,1513,414,147,260,214
JHM,6,2008,2824,1691,1133,374,315,180,112
JHM,6,2008,11664,6509,5155,1324,2762,4038,531
JHM,6,2008,4195,2540,1655,621,350,128,208
JHM,6,2008,3406,1834,1572,473,294,301,201
JHM,6,2008,7576,4008,3568,844,350,358,415
JHM,6,2008,1850,1114,736,331,180,224,79
JHM,6,2008,4894,2829,2065,547,293,305,258
OLK,6,2008,1884,1062,822,215,54,54,82
OLK,6,2008,6106,3404,2702,938,832,1205,330
OLK,6,2008,2157,1367,790,339,166,228,85
OLK,6,2008,4814,2713,2101,515,374,315,229
OLK,6,2008,4327,2489,1838,548,370,212,256
ZLK,6,2008,3594,2064,1530,448,238,202,194
ZLK,6,2008,3714,2200,1514,443,248,236,162
ZLK,6,2008,4802,2541,2261,540,379,483,236
ZLK,6,2008,4681,2785,1896,693,552,425,272
MSK,6,2008,4733,2697,2036,472,317,244,175
MSK,6,2008,6664,3746,2918,993,1818,425,327
MSK,6,2008,17510,9571,7939,1259,571,563,700
MSK,6,2008,3999,2207,1792,566,417,345,199
MSK,6,2008,6310,3456,2854,708,273,377,317
MSK,6,2008,15312,8169,7143,1637,2504,1316,661
PHA,7,2008,17106,9268,7838,4080,7560,6882,718
STC,7,2008,1397,828,569,368,161,144,83
STC,7,2008,1551,891,660,312,279,348,83
STC,7,2008,4863,2784,2079,777,245,259,289
STC,7,2008,2633,1541,1092,553,287,257,175
STC,7,2008,2070,1293,777,423,1015,1745,121
STC,7,2008,2833,1771,1062,492,581,432,172
STC,7,2008,1800,1091,709,368,1360,1477,92
STC,7,2008,2647,1503,1144,451,392,394,157
STC,7,2008,1290,747,543,360,1133,1013,61
STC,7,2008,1068,623,445,302,125,435,52
STC,7,2008,3242,1717,1525,588,332,300,176
STC,7,2008,1358,797,561,278,270,127,105
JHC,7,2008,3418,1979,1439,867,485,501,300
JHC,7,2008,1821,1012,809,305,127,230,101
JHC,7,2008,1488,924,564,362,125,160,82
JHC,7,2008,1458,876,582,335,227,372,96
JHC,7,2008,1080,630,450,222,74,91,73
JHC,7,2008,1961,1160,801,319,224,252,99
JHC,7,2008,2398,1424,974,544,293,321,205
PLK,7,2008,1416,898,518,306,64,79,65
PLK,7,2008,2437,1419,1018,429,249,214,143
PLK,7,2008,3930,2311,1619,910,1829,1786,229
PLK,7,2008,927,521,406,215,78,56,59
PLK,7,2008,1602,1002,600,283,70,72,120
PLK,7,2008,1052,640,412,215,155,152,81
PLK,7,2008,2001,1032,969,310,116,229,107
KVK,7,2008,2949,1478,1471,505,196,155,135
KVK,7,2008,4556,2333,2223,632,344,558,240
KVK,7,2008,4054,2170,1884,608,140,181,224
ULK,7,2008,7517,4031,3486,856,230,215,355
ULK,7,2008,5727,3212,2515,897,293,343,256
ULK,7,2008,4515,2522,1993,769,553,421,259
ULK,7,2008,4005,2159,1846,527,467,228,198
ULK,7,2008,7944,4343,3601,808,318,187,377
ULK,7,2008,6306,3705,2601,677,238,220,343
ULK,7,2008,6170,3391,2779,721,251,247,357
LBK,7,2008,3622,2047,1575,713,216,288,201
LBK,7,2008,2800,1609,1191,522,210,288,198
LBK,7,2008,5681,3180,2501,1012,1050,1052,339
LBK,7,2008,2249,1319,930,371,179,77,126
HKK,7,2008,3401,1969,1432,710,642,852,208
HKK,7,2008,2154,1267,887,410,139,168,122
HKK,7,2008,2156,1242,914,526,231,261,156
HKK,7,2008,1126,726,400,362,169,216,62
HKK,7,2008,3665,2020,1645,707,388,711,198
PAK,7,2008,2716,1679,1037,576,400,372,168
PAK,7,2008,3237,1831,1406,777,328,351,294
PAK,7,2008,4031,2312,1719,606,255,226,228
PAK,7,2008,3562,2064,1498,707,422,971,203
VYS,7,2008,2054,1286,768,384,266,356,139
VYS,7,2008,3048,1710,1338,665,483,487,187
VYS,7,2008,1279,769,510,345,185,389,73
VYS,7,2008,4275,2580,1695,616,177,247,282
VYS,7,2008,3567,2029,1538,592,231,250,248
JHM,7,2008,2991,1789,1202,524,163,314,139
JHM,7,2008,12189,6922,5267,1839,2829,2596,619
JHM,7,2008,4441,2719,1722,822,214,337,255
JHM,7,2008,3588,1985,1603,662,277,280,235
JHM,7,2008,7832,4209,3623,1060,328,259,476
JHM,7,2008,1956,1218,738,433,161,82,103
JHM,7,2008,4964,2915,2049,690,426,399,278
OLK,7,2008,1914,1084,830,276,30,59,100
OLK,7,2008,6442,3699,2743,1284,865,955,403
OLK,7,2008,2188,1416,772,443,253,303,90
OLK,7,2008,5048,2868,2180,713,222,340,269
OLK,7,2008,4452,2574,1878,724,212,228,292
ZLK,7,2008,3717,2200,1517,573,170,266,237
ZLK,7,2008,4056,2473,1583,815,310,289,194
ZLK,7,2008,5028,2704,2324,761,485,401,291
ZLK,7,2008,4923,2957,1966,910,564,515,336
MSK,7,2008,4839,2771,2068,636,217,215,194
MSK,7,2008,6847,3897,2950,1207,460,458,401
MSK,7,2008,17379,9608,7771,1520,630,545,710
MSK,7,2008,4213,2314,1899,807,393,278,218
MSK,7,2008,6448,3544,2904,891,301,376,385
MSK,7,2008,15390,8314,7076,1940,1126,994,706
PHA,8,2008,17309,9374,7935,3004,6170,5966,815
STC,8,2008,1427,839,588,300,398,328,105
STC,8,2008,1600,933,667,276,337,853,98
STC,8,2008,4897,2791,2106,659,167,206,309
STC,8,2008,2762,1616,1146,471,562,664,204
STC,8,2008,2131,1298,833,314,306,344,138
STC,8,2008,2858,1775,1083,359,331,337,182
STC,8,2008,1851,1131,720,298,983,1081,110
STC,8,2008,2715,1542,1173,383,189,416,186
STC,8,2008,1339,767,572,286,572,665,62
STC,8,2008,1094,634,460,244,93,64,54
STC,8,2008,3290,1722,1568,474,244,229,209
STC,8,2008,1321,776,545,179,86,130,112
JHC,8,2008,3489,2038,1451,671,495,447,335
JHC,8,2008,1905,1061,844,337,222,144,119
JHC,8,2008,1509,940,569,270,98,179,118
JHC,8,2008,1551,930,621,391,426,264,116
JHC,8,2008,1099,627,472,179,107,65,96
JHC,8,2008,1987,1156,831,260,169,121,107
JHC,8,2008,2482,1474,1008,442,344,339,234
PLK,8,2008,1467,915,552,222,83,173,83
PLK,8,2008,2524,1482,1042,412,157,188,175
PLK,8,2008,4057,2403,1654,719,1415,2600,300
PLK,8,2008,1048,571,477,283,58,57,81
PLK,8,2008,1689,1034,655,285,126,99,129
PLK,8,2008,1085,652,433,179,136,206,97
PLK,8,2008,2122,1120,1002,316,43,90,128
KVK,8,2008,2991,1509,1482,422,178,334,138
KVK,8,2008,4595,2350,2245,502,347,269,266
KVK,8,2008,4103,2226,1877,505,140,188,241
ULK,8,2008,7512,4067,3445,751,187,221,371
ULK,8,2008,5685,3197,2488,668,226,288,284
ULK,8,2008,4531,2544,1987,542,465,307,273
ULK,8,2008,3973,2127,1846,514,275,177,229
ULK,8,2008,7750,4263,3487,629,262,109,399
ULK,8,2008,6210,3658,2552,575,220,179,390
ULK,8,2008,6023,3362,2661,548,279,329,366
LBK,8,2008,3641,2068,1573,485,185,248,203
LBK,8,2008,2851,1643,1208,380,192,142,213
LBK,8,2008,5741,3211,2530,834,909,796,371
LBK,8,2008,2252,1327,925,287,188,206,147
HKK,8,2008,3424,2009,1415,593,660,483,238
HKK,8,2008,2146,1291,855,324,198,188,139
HKK,8,2008,2147,1262,885,427,204,389,179
HKK,8,2008,1163,739,424,254,139,191,66
HKK,8,2008,3554,1938,1616,454,445,373,235
PAK,8,2008,2770,1695,1075,409,228,319,206
PAK,8,2008,3352,1880,1472,616,927,627,314
PAK,8,2008,4006,2307,1699,444,202,286,240
PAK,8,2008,3724,2161,1563,605,587,354,273
VYS,8,2008,2150,1346,804,323,207,208,179
VYS,8,2008,3104,1758,1346,431,344,281,238
VYS,8,2008,1329,787,542,264,140,249,94
VYS,8,2008,4326,2617,1709,514,134,123,333
VYS,8,2008,3654,2072,1582,463,184,226,300
JHM,8,2008,3034,1848,1186,448,260,265,170
JHM,8,2008,12327,7009,5318,1432,3756,3290,665
JHM,8,2008,4479,2717,1762,641,477,586,286
JHM,8,2008,3587,1986,1601,525,324,220,284
JHM,8,2008,7815,4181,3634,804,220,311,592
JHM,8,2008,2072,1286,786,430,152,171,139
JHM,8,2008,4956,2920,2036,548,386,341,349
OLK,8,2008,1928,1101,827,212,70,40,119
OLK,8,2008,6427,3714,2713,924,854,761,468
OLK,8,2008,2192,1412,780,359,267,217,100
OLK,8,2008,5084,2896,2188,559,573,346,307
OLK,8,2008,4452,2592,1860,495,238,198,329
ZLK,8,2008,3776,2225,1551,501,413,264,278
ZLK,8,2008,4111,2513,1598,527,250,252,234
ZLK,8,2008,5065,2731,2334,578,320,351,341
ZLK,8,2008,4948,2977,1971,709,514,515,415
MSK,8,2008,4874,2799,2075,495,147,214,242
MSK,8,2008,6785,3842,2943,885,600,293,462
MSK,8,2008,17171,9535,7636,1349,716,487,824
MSK,8,2008,4269,2362,1907,630,444,302,281
MSK,8,2008,6457,3538,2919,690,317,324,464
MSK,8,2008,15209,8264,6945,1441,1032,539,742
PHA,9,2008,17136,9093,8043,4370,7390,10405,1158
STC,9,2008,1464,825,639,445,225,266,191
STC,9,2008,1632,921,711,439,233,280,200
STC,9,2008,4879,2775,2104,907,473,324,437
STC,9,2008,2757,1569,1188,696,461,437,276
STC,9,2008,2178,1262,916,474,312,335,202
STC,9,2008,2933,1762,1171,627,227,391,290
STC,9,2008,1929,1156,773,494,330,633,177
STC,9,2008,2795,1530,1265,607,664,580,265
STC,9,2008,1402,800,602,464,1170,1050,138
STC,9,2008,1084,622,462,340,204,181,109
STC,9,2008,3384,1731,1653,764,235,317,358
STC,9,2008,1320,759,561,343,143,145,152
JHC,9,2008,3532,2007,1525,1016,502,542,453
JHC,9,2008,2021,1109,912,499,146,184,194
JHC,9,2008,1631,994,637,505,144,216,185
JHC,9,2008,1583,923,660,427,282,471,171
JHC,9,2008,1129,639,490,344,107,143,157
JHC,9,2008,2056,1148,908,476,185,188,172
JHC,9,2008,2500,1462,1038,655,277,394,318
PLK,9,2008,1534,947,587,366,64,143,133
PLK,9,2008,2569,1438,1131,595,203,336,284
PLK,9,2008,3994,2274,1720,966,2255,2450,406
PLK,9,2008,1091,594,497,318,68,99,135
PLK,9,2008,1774,1045,729,464,135,261,231
PLK,9,2008,1114,669,445,272,134,128,131
PLK,9,2008,2163,1126,1037,387,71,125,178
KVK,9,2008,3093,1504,1589,665,182,222,206
KVK,9,2008,4666,2318,2348,789,300,522,360
KVK,9,2008,4134,2193,1941,828,171,123,405
ULK,9,2008,7592,4073,3519,1192,181,270,572
ULK,9,2008,5754,3193,2561,1074,372,469,420
ULK,9,2008,4607,2535,2072,886,691,685,398
ULK,9,2008,4003,2125,1878,747,205,280,332
ULK,9,2008,7658,4152,3506,967,272,238,531
ULK,9,2008,6231,3584,2647,950,227,386,579
ULK,9,2008,5984,3278,2706,907,245,260,483
LBK,9,2008,3657,2050,1607,722,293,357,274
LBK,9,2008,2930,1663,1267,606,237,272,289
LBK,9,2008,5743,3187,2556,1250,912,1231,502
LBK,9,2008,2318,1315,1003,483,137,157,209
HKK,9,2008,3394,1930,1464,879,846,1061,380
HKK,9,2008,2133,1259,874,483,97,189,214
HKK,9,2008,2108,1211,897,644,412,416,283
HKK,9,2008,1263,749,514,456,129,228,155
HKK,9,2008,3497,1888,1609,739,425,427,341
PAK,9,2008,2893,1711,1182,760,281,377,350
PAK,9,2008,3493,1909,1584,988,630,2968,453
PAK,9,2008,4026,2262,1764,769,341,292,374
PAK,9,2008,3781,2112,1669,845,432,585,419
VYS,9,2008,2185,1344,841,509,213,321,265
VYS,9,2008,3135,1740,1395,748,525,648,357
VYS,9,2008,1380,794,586,429,159,200,170
VYS,9,2008,4357,2565,1792,766,114,200,470
VYS,9,2008,3573,1958,1615,668,196,337,393
JHM,9,2008,3132,1872,1260,631,209,327,297
JHM,9,2008,12418,7012,5406,2212,2338,2537,755
JHM,9,2008,4638,2779,1859,1134,439,312,523
JHM,9,2008,3677,1969,1708,913,336,365,462
JHM,9,2008,7777,4144,3633,1175,367,350,731
JHM,9,2008,2183,1281,902,655,150,303,237
JHM,9,2008,4954,2873,2081,929,278,316,529
OLK,9,2008,1937,1087,850,350,44,46,168
OLK,9,2008,6469,3611,2858,1516,878,727,717
OLK,9,2008,2257,1425,832,564,218,368,188
OLK,9,2008,5117,2834,2283,874,281,319,439
OLK,9,2008,4443,2540,1903,858,217,365,401
ZLK,9,2008,3720,2130,1590,714,174,225,393
ZLK,9,2008,4055,2394,1661,800,194,180,319
ZLK,9,2008,5172,2717,2455,959,393,381,489
ZLK,9,2008,4964,2942,2022,1103,552,727,582
MSK,9,2008,4939,2835,2104,787,188,231,392
MSK,9,2008,6593,3672,2921,1298,770,675,636
MSK,9,2008,16981,9423,7558,1904,678,879,1113
MSK,9,2008,4440,2417,2023,1050,354,970,464
MSK,9,2008,6438,3483,2955,1105,441,424,648
MSK,9,2008,15082,8065,7017,2347,652,1594,1117
PHA,10,2008,16866,8841,8025,3750,7706,6873,1103
STC,10,2008,1416,766,650,356,257,234,154
STC,10,2008,1579,886,693,316,516,615,178
STC,10,2008,4907,2721,2186,815,295,437,430
STC,10,2008,2739,1541,1198,574,384,386,248
STC,10,2008,2208,1249,959,413,245,196,183
STC,10,2008,2861,1720,1141,441,348,484,252
STC,10,2008,1972,1173,799,436,863,1360,174
STC,10,2008,2789,1497,1292,456,511,445,264
STC,10,2008,1419,807,612,370,456,574,135
STC,10,2008,1075,604,471,308,140,126,93
STC,10,2008,3333,1673,1660,536,210,288,334
STC,10,2008,1340,761,579,274,141,361,135
JHC,10,2008,3447,1930,1517,768,443,483,420
JHC,10,2008,2125,1166,959,438,129,265,180
JHC,10,2008,1682,997,685,413,178,249,155
JHC,10,2008,1568,899,669,329,143,347,143
JHC,10,2008,1120,628,492,268,122,232,142
JHC,10,2008,2065,1142,923,338,137,219,175
JHC,10,2008,2499,1433,1066,477,230,299,267
PLK,10,2008,1557,959,598,289,150,202,138
PLK,10,2008,2585,1445,1140,455,262,441,256
PLK,10,2008,3916,2194,1722,775,1753,1931,369
PLK,10,2008,1034,568,466,216,40,111,125
PLK,10,2008,1677,989,688,259,81,88,177
PLK,10,2008,1086,667,419,190,87,115,107
PLK,10,2008,2275,1165,1110,407,118,249,186
KVK,10,2008,3229,1582,1647,583,152,239,224
KVK,10,2008,4684,2302,2382,671,318,398,345
KVK,10,2008,4092,2164,1928,608,100,199,390
ULK,10,2008,7596,4091,3505,910,124,257,549
ULK,10,2008,5737,3153,2584,877,311,440,396
ULK,10,2008,4646,2570,2076,675,303,491,389
ULK,10,2008,3947,2091,1856,554,557,784,290
ULK,10,2008,7685,4141,3544,853,353,366,502
ULK,10,2008,6159,3513,2646,734,224,330,554
ULK,10,2008,5985,3241,2744,761,360,311,429
LBK,10,2008,3692,2056,1636,624,167,431,288
LBK,10,2008,3034,1712,1322,544,205,361,293
LBK,10,2008,5580,3005,2575,932,879,964,433
LBK,10,2008,2418,1362,1056,420,124,127,197
HKK,10,2008,3413,1896,1517,742,780,705,406
HKK,10,2008,2145,1266,879,393,72,186,192
HKK,10,2008,2130,1204,926,543,213,336,258
HKK,10,2008,1309,768,541,349,126,172,149
HKK,10,2008,3612,1937,1675,721,405,570,305
PAK,10,2008,2843,1644,1199,512,251,512,314
PAK,10,2008,3487,1880,1607,730,870,1755,436
PAK,10,2008,4016,2223,1793,555,199,282,339
PAK,10,2008,3758,2078,1680,651,319,555,365
VYS,10,2008,2242,1374,868,445,182,215,245
VYS,10,2008,3082,1662,1420,596,369,372,313
VYS,10,2008,1461,867,594,396,137,160,148
VYS,10,2008,4344,2525,1819,635,155,199,442
VYS,10,2008,3464,1883,1581,466,158,218,341
JHM,10,2008,3064,1841,1223,423,124,322,270
JHM,10,2008,12160,6754,5406,1559,1438,2102,750
JHM,10,2008,4523,2658,1865,705,405,945,454
JHM,10,2008,3669,1947,1722,654,234,372,423
JHM,10,2008,7726,4115,3611,878,227,359,675
JHM,10,2008,2149,1262,887,450,110,162,213
JHM,10,2008,4963,2860,2103,727,426,431,468
OLK,10,2008,1936,1079,857,286,35,76,147
OLK,10,2008,6299,3486,2813,1109,955,1188,611
OLK,10,2008,2289,1406,883,461,165,351,168
OLK,10,2008,5045,2780,2265,667,274,381,418
OLK,10,2008,4395,2469,1926,654,199,406,359
ZLK,10,2008,3643,2046,1597,499,196,239,362
ZLK,10,2008,3988,2361,1627,585,501,492,277
ZLK,10,2008,5121,2661,2460,636,292,815,441
ZLK,10,2008,4814,2813,2001,745,417,497,506
MSK,10,2008,4924,2807,2117,573,178,238,359
MSK,10,2008,6161,3379,2782,976,457,820,551
MSK,10,2008,16520,9087,7433,1462,456,702,1016
MSK,10,2008,4391,2349,2042,744,261,370,398
MSK,10,2008,6341,3435,2906,809,354,570,590
MSK,10,2008,14654,7768,6886,1654,1061,1173,993
PHA,11,2008,16784,8732,8052,3265,5996,6730,971
STC,11,2008,1392,764,628,284,130,233,129
STC,11,2008,1590,888,702,263,446,632,159
STC,11,2008,4864,2662,2202,666,214,435,391
STC,11,2008,2859,1581,1278,548,178,441,239
STC,11,2008,2311,1310,1001,417,269,655,168
STC,11,2008,2878,1730,1148,430,193,343,224
STC,11,2008,2055,1148,907,405,1189,1793,150
STC,11,2008,3072,1590,1482,634,103,272,245
STC,11,2008,1439,793,646,319,619,999,113
STC,11,2008,1075,595,480,231,151,131,70
STC,11,2008,3411,1673,1738,551,175,509,308
STC,11,2008,1404,783,621,279,66,195,129
JHC,11,2008,3484,1939,1545,675,362,522,368
JHC,11,2008,2281,1240,1041,462,33,93,166
JHC,11,2008,1840,1058,782,468,102,156,157
JHC,11,2008,1619,925,694,313,129,458,124
JHC,11,2008,1211,636,575,276,46,123,151
JHC,11,2008,2143,1165,978,316,206,283,180
JHC,11,2008,2543,1438,1105,424,159,350,244
PLK,11,2008,1653,984,669,305,37,193,131
PLK,11,2008,2744,1508,1236,528,123,224,221
PLK,11,2008,3987,2172,1815,757,1863,1984,323
PLK,11,2008,1060,579,481,228,12,130,113
PLK,11,2008,1740,1004,736,306,215,242,160
PLK,11,2008,1176,725,451,226,24,89,98
PLK,11,2008,2405,1208,1197,368,85,186,182
KVK,11,2008,3379,1658,1721,529,123,318,211
KVK,11,2008,4812,2332,2480,643,188,278,325
KVK,11,2008,4200,2201,1999,589,120,191,354
ULK,11,2008,7774,4191,3583,901,79,108,510
ULK,11,2008,5909,3202,2707,891,137,399,390
ULK,11,2008,4711,2547,2164,638,449,645,357
ULK,11,2008,4107,2143,1964,600,395,374,280
ULK,11,2008,7739,4163,3576,726,197,328,473
ULK,11,2008,6161,3462,2699,648,134,258,520
ULK,11,2008,6109,3262,2847,719,187,199,419
LBK,11,2008,3908,2138,1770,639,85,134,269
LBK,11,2008,3116,1715,1401,494,175,268,269
LBK,11,2008,5745,2974,2771,1008,477,995,387
LBK,11,2008,2512,1356,1156,377,106,356,180
HKK,11,2008,3391,1849,1542,612,547,602,353
HKK,11,2008,2233,1266,967,412,78,365,180
HKK,11,2008,2310,1231,1079,583,132,347,231
HKK,11,2008,1409,806,603,311,82,171,138
HKK,11,2008,3783,1997,1786,689,354,525,294
PAK,11,2008,3031,1668,1363,615,201,455,270
PAK,11,2008,3506,1846,1660,652,283,945,372
PAK,11,2008,4162,2259,1903,610,139,304,318
PAK,11,2008,3989,2176,1813,724,172,455,340
VYS,11,2008,2652,1538,1114,708,72,160,228
VYS,11,2008,3287,1724,1563,664,230,380,288
VYS,11,2008,1596,885,711,372,69,169,141
VYS,11,2008,4469,2600,1869,661,71,192,409
VYS,11,2008,3579,1909,1670,540,116,227,309
JHM,11,2008,3195,1848,1347,451,64,187,248
JHM,11,2008,12036,6595,5441,1442,1280,5319,694
JHM,11,2008,4477,2598,1879,657,152,365,384
JHM,11,2008,3811,1995,1816,681,187,323,393
JHM,11,2008,7929,4121,3808,916,211,339,660
JHM,11,2008,2176,1231,945,382,127,216,189
JHM,11,2008,5500,3194,2306,1055,210,416,437
OLK,11,2008,2114,1154,960,402,38,46,149
OLK,11,2008,6541,3528,3013,1182,568,732,585
OLK,11,2008,2383,1419,964,448,117,227,158
OLK,11,2008,5018,2725,2293,580,110,356,382
OLK,11,2008,4641,2547,2094,769,165,245,337
ZLK,11,2008,3757,2031,1726,566,133,364,333
ZLK,11,2008,4098,2383,1715,593,154,484,257
ZLK,11,2008,5256,2666,2590,704,235,479,416
ZLK,11,2008,4915,2807,2108,752,235,330,469
MSK,11,2008,5286,2956,2330,789,116,159,361
MSK,11,2008,6155,3260,2895,1031,641,1784,472
MSK,11,2008,16404,8971,7433,1426,342,566,931
MSK,11,2008,4781,2455,2326,955,255,597,377
MSK,11,2008,6426,3416,3010,775,165,247,529
MSK,11,2008,14801,7646,7155,1720,765,1280,931
PHA,12,2008,17433,8940,8493,3383,4831,7598,904
STC,12,2008,1569,806,763,422,63,308,130
STC,12,2008,1721,918,803,326,271,354,171
STC,12,2008,5058,2724,2334,721,119,282,379
STC,12,2008,3224,1725,1499,669,98,366,249
STC,12,2008,2700,1491,1209,585,46,179,168
STC,12,2008,3066,1781,1285,499,149,473,227
STC,12,2008,2279,1234,1045,478,69,292,154
STC,12,2008,3412,1726,1686,576,393,450,235
STC,12,2008,1509,812,697,299,149,535,96
STC,12,2008,1166,620,546,259,114,94,76
STC,12,2008,3887,1826,2061,858,215,359,287
STC,12,2008,1629,848,781,383,78,115,123
JHC,12,2008,3852,2096,1756,808,205,414,373
JHC,12,2008,2565,1297,1268,505,20,79,169
JHC,12,2008,2312,1243,1069,667,93,121,180
JHC,12,2008,2051,1099,952,644,91,196,111
JHC,12,2008,1422,691,731,340,43,165,159
JHC,12,2008,2342,1216,1126,392,63,222,183
JHC,12,2008,2961,1623,1338,666,93,278,252
PLK,12,2008,1854,1063,791,348,80,80,136
PLK,12,2008,3060,1595,1465,645,101,154,220
PLK,12,2008,4274,2298,1976,819,1215,4483,306
PLK,12,2008,1154,620,534,247,22,108,108
PLK,12,2008,2030,1153,877,472,71,86,160
PLK,12,2008,1338,817,521,271,42,63,99
PLK,12,2008,3047,1479,1568,791,14,72,199
KVK,12,2008,3792,1800,1992,727,127,151,213
KVK,12,2008,5111,2440,2671,706,205,343,336
KVK,12,2008,4534,2337,2197,676,55,78,369
ULK,12,2008,8253,4319,3934,1017,74,53,500
ULK,12,2008,6453,3402,3051,1041,112,184,412
ULK,12,2008,5230,2742,2488,923,201,321,350
ULK,12,2008,4624,2334,2290,867,123,177,268
ULK,12,2008,8194,4356,3838,967,72,220,473
ULK,12,2008,6595,3647,2948,938,92,207,516
ULK,12,2008,6308,3313,2995,654,73,175,426
LBK,12,2008,4308,2312,1996,752,149,416,264
LBK,12,2008,3339,1773,1566,512,107,146,260
LBK,12,2008,6233,3112,3121,1095,313,453,409
LBK,12,2008,2725,1380,1345,477,48,190,179
HKK,12,2008,3692,1920,1772,772,282,520,327
HKK,12,2008,2568,1376,1192,528,54,133,196
HKK,12,2008,2697,1341,1356,712,166,267,247
HKK,12,2008,1639,904,735,421,51,122,142
HKK,12,2008,4132,2064,2068,780,317,409,293
PAK,12,2008,3618,1801,1817,869,113,229,288
PAK,12,2008,3952,1996,1956,925,282,979,373
PAK,12,2008,4768,2460,2308,924,79,154,328
PAK,12,2008,4660,2387,2273,984,189,275,366
VYS,12,2008,3037,1698,1339,604,46,171,238
VYS,12,2008,3868,1861,2007,912,167,598,293
VYS,12,2008,1870,936,934,461,60,182,150
VYS,12,2008,5088,2758,2330,937,57,133,404
VYS,12,2008,4011,2025,1986,686,155,274,340
JHM,12,2008,3535,1986,1549,638,70,126,249
JHM,12,2008,12641,6782,5859,1679,1202,2077,672
JHM,12,2008,4839,2718,2121,845,61,551,360
JHM,12,2008,4429,2212,2217,971,101,181,406
JHM,12,2008,8819,4384,4435,1408,109,138,692
JHM,12,2008,2452,1274,1178,489,71,46,204
JHM,12,2008,6348,3465,2883,1284,126,249,436
OLK,12,2008,2540,1252,1288,646,22,50,149
OLK,12,2008,7359,3756,3603,1501,296,587,616
OLK,12,2008,2789,1642,1147,683,76,221,173
OLK,12,2008,5484,2845,2639,880,91,498,363
OLK,12,2008,5298,2755,2543,1041,91,305,344
ZLK,12,2008,4123,2140,1983,660,72,168,329
ZLK,12,2008,4628,2531,2097,865,57,524,268
ZLK,12,2008,5832,2848,2984,971,177,419,446
ZLK,12,2008,5465,3031,2434,981,212,997,490
MSK,12,2008,5829,3083,2746,868,92,203,362
MSK,12,2008,6814,3407,3407,1356,295,862,490
MSK,12,2008,16896,9085,7811,1704,209,527,931
MSK,12,2008,5522,2685,2837,1134,109,426,388
MSK,12,2008,7032,3531,3501,1078,135,260,553
MSK,12,2008,15362,7692,7670,1799,376,1784,899
PHA,1,2009,18616,9352,9264,4690,6658,9879,858
STC,1,2009,1766,861,905,593,197,589,119
STC,1,2009,2040,1033,1007,600,465,560,170
STC,1,2009,5550,2933,2617,1145,216,413,369
STC,1,2009,3512,1806,1706,742,299,362,254
STC,1,2009,2973,1580,1393,612,152,478,166
STC,1,2009,3355,1853,1502,691,285,583,240
STC,1,2009,2595,1353,1242,678,523,1010,156
STC,1,2009,3651,1767,1884,657,585,923,245
STC,1,2009,1661,865,796,518,645,679,89
STC,1,2009,1347,718,629,442,136,609,75
STC,1,2009,4428,2017,2411,1055,247,482,265
STC,1,2009,1754,864,890,394,100,392,118
JHC,1,2009,4400,2314,2086,1275,355,700,394
JHC,1,2009,3109,1525,1584,829,44,152,179
JHC,1,2009,3001,1531,1470,983,175,228,213
JHC,1,2009,2431,1215,1216,637,127,340,130
JHC,1,2009,1610,718,892,413,77,151,146
JHC,1,2009,2676,1292,1384,576,110,479,182
JHC,1,2009,3384,1757,1627,825,165,239,268
PLK,1,2009,2157,1146,1011,567,42,281,126
PLK,1,2009,3437,1726,1711,817,174,395,209
PLK,1,2009,4724,2478,2246,1242,821,2199,291
PLK,1,2009,1381,703,678,408,74,129,102
PLK,1,2009,2367,1256,1111,647,146,368,182
PLK,1,2009,1494,845,649,311,120,160,91
PLK,1,2009,3376,1607,1769,574,34,122,196
KVK,1,2009,4463,2041,2422,1120,101,183,222
KVK,1,2009,5777,2773,3004,1175,292,530,345
KVK,1,2009,5159,2572,2587,1030,103,337,393
ULK,1,2009,9216,4614,4602,1610,278,246,518
ULK,1,2009,7262,3719,3543,1465,222,517,427
ULK,1,2009,5697,2892,2805,1045,489,663,367
ULK,1,2009,5053,2481,2572,914,172,293,287
ULK,1,2009,8735,4541,4194,1245,122,210,483
ULK,1,2009,7138,3801,3337,1181,129,210,545
ULK,1,2009,6580,3355,3225,959,196,235,444
LBK,1,2009,5530,2796,2734,1658,224,409,287
LBK,1,2009,3674,1870,1804,794,134,262,245
LBK,1,2009,7113,3448,3665,1697,691,817,431
LBK,1,2009,2949,1449,1500,665,85,177,163
HKK,1,2009,4152,2037,2115,1138,731,1766,316
HKK,1,2009,2949,1456,1493,674,59,149,196
HKK,1,2009,3488,1640,1848,1224,241,381,249
HKK,1,2009,1965,1018,947,599,131,198,136
HKK,1,2009,4686,2294,2392,1146,255,454,324
PAK,1,2009,4273,1931,2342,1094,157,236,283
PAK,1,2009,4571,2242,2329,1264,430,793,379
PAK,1,2009,5443,2646,2797,1083,156,433,340
PAK,1,2009,5418,2559,2859,1338,259,319,396
VYS,1,2009,3560,1845,1715,800,162,316,258
VYS,1,2009,4637,2076,2561,1237,325,431,305
VYS,1,2009,2308,1052,1256,684,140,170,139
VYS,1,2009,5786,2964,2822,1164,144,186,421
VYS,1,2009,4641,2195,2446,1048,86,221,362
JHM,1,2009,4202,2233,1969,977,147,274,288
JHM,1,2009,13338,6914,6424,2314,1926,2012,664
JHM,1,2009,5446,2946,2500,1304,305,1629,348
JHM,1,2009,5159,2440,2719,1249,157,271,411
JHM,1,2009,9786,4621,5165,1698,231,184,688
JHM,1,2009,2880,1392,1488,750,129,259,212
JHM,1,2009,7344,3787,3557,1532,245,356,467
OLK,1,2009,2849,1285,1564,569,34,76,143
OLK,1,2009,8771,4215,4556,2302,588,1077,628
OLK,1,2009,3283,1815,1468,888,95,268,177
OLK,1,2009,6090,3007,3083,1148,129,419,351
OLK,1,2009,6341,3081,3260,1483,161,344,384
ZLK,1,2009,4658,2277,2381,1019,142,674,324
ZLK,1,2009,5400,2773,2627,1263,110,357,279
ZLK,1,2009,6818,3156,3662,1490,285,496,482
ZLK,1,2009,6294,3306,2988,1500,256,468,533
MSK,1,2009,6509,3276,3233,1203,163,206,380
MSK,1,2009,7886,3740,4146,1930,300,1007,529
MSK,1,2009,18227,9518,8709,2646,339,811,962
MSK,1,2009,6860,3173,3687,1893,215,530,380
MSK,1,2009,7927,3771,4156,1645,208,341,558
MSK,1,2009,16975,8119,8856,3101,493,2736,935
PHA,2,2009,19845,9615,10230,4566,7786,6675,840
STC,2,2009,2002,958,1044,535,102,99,146
STC,2,2009,2296,1102,1194,526,163,175,165
STC,2,2009,5902,3081,2821,952,263,316,396
STC,2,2009,3709,1890,1819,621,150,272,244
STC,2,2009,3191,1658,1533,487,202,121,183
STC,2,2009,3496,1864,1632,558,404,259,243
STC,2,2009,3047,1533,1514,748,153,293,163
STC,2,2009,3804,1819,1985,502,664,552,249
STC,2,2009,1794,908,886,458,623,285,84
STC,2,2009,1484,745,739,376,108,228,76
STC,2,2009,4637,2089,2548,693,144,228,267
STC,2,2009,1882,915,967,362,153,94,133
JHC,2,2009,4857,2499,2358,1078,273,486,450
JHC,2,2009,3185,1515,1670,428,159,179,188
JHC,2,2009,3389,1684,1705,688,61,115,235
JHC,2,2009,2644,1314,1330,454,99,175,140
JHC,2,2009,1735,764,971,305,57,112,156
JHC,2,2009,2840,1356,1484,413,64,227,182
JHC,2,2009,3706,1852,1854,633,156,170,307
PLK,2,2009,2394,1234,1160,478,35,75,124
PLK,2,2009,3605,1775,1830,576,249,188,223
PLK,2,2009,5089,2670,2419,1114,797,1482,270
PLK,2,2009,1527,771,756,329,31,100,96
PLK,2,2009,2620,1393,1227,509,148,180,175
PLK,2,2009,1702,937,765,369,47,68,101
PLK,2,2009,3655,1728,1927,538,64,131,200
KVK,2,2009,4741,2133,2608,726,204,160,225
KVK,2,2009,6222,2955,3267,880,162,200,363
KVK,2,2009,5495,2696,2799,786,90,174,418
ULK,2,2009,9504,4689,4815,985,77,177,518
ULK,2,2009,7763,3958,3805,1149,123,210,445
ULK,2,2009,5940,2973,2967,719,302,377,358
ULK,2,2009,5470,2668,2802,866,75,69,297
ULK,2,2009,9076,4686,4390,1014,97,241,472
ULK,2,2009,7488,3951,3537,988,168,214,542
ULK,2,2009,6920,3464,3456,856,128,239,476
LBK,2,2009,6238,3129,3109,1112,236,195,316
LBK,2,2009,3997,1974,2023,708,72,116,258
LBK,2,2009,7675,3597,4078,1350,621,794,426
LBK,2,2009,3196,1517,1679,471,67,90,173
HKK,2,2009,4390,2114,2276,784,377,568,312
HKK,2,2009,3233,1569,1664,534,130,180,205
HKK,2,2009,3744,1739,2005,718,160,213,231
HKK,2,2009,2188,1086,1102,465,51,152,151
HKK,2,2009,5096,2483,2613,832,186,302,341
PAK,2,2009,4509,2030,2479,629,193,232,297
PAK,2,2009,4837,2321,2516,871,284,402,375
PAK,2,2009,5812,2773,3039,773,238,180,372
PAK,2,2009,6025,2749,3276,1114,212,251,416
VYS,2,2009,4286,2080,2206,992,85,78,276
VYS,2,2009,5131,2276,2855,860,215,496,341
VYS,2,2009,2458,1094,1364,385,63,102,142
VYS,2,2009,6091,3063,3028,789,106,159,457
VYS,2,2009,4990,2315,2675,705,138,259,369
JHM,2,2009,4595,2419,2176,744,90,181,310
JHM,2,2009,14112,7129,6983,2065,1495,1380,688
JHM,2,2009,5894,3091,2803,1055,191,173,383
JHM,2,2009,5666,2656,3010,989,204,163,439
JHM,2,2009,10353,4780,5573,1269,200,254,713
JHM,2,2009,3111,1453,1658,522,93,203,249
JHM,2,2009,7800,3958,3842,1019,174,330,498
OLK,2,2009,3049,1279,1770,485,22,23,152
OLK,2,2009,10246,4629,5617,2320,566,541,677
OLK,2,2009,3648,1984,1664,724,105,88,206
OLK,2,2009,6541,3163,3378,892,140,216,364
OLK,2,2009,7011,3344,3667,1088,144,175,433
ZLK,2,2009,4968,2372,2596,713,78,352,355
ZLK,2,2009,5845,2898,2947,911,97,380,287
ZLK,2,2009,7500,3437,4063,1154,233,278,516
ZLK,2,2009,6892,3479,3413,1238,334,331,578
MSK,2,2009,7052,3500,3552,982,115,177,396
MSK,2,2009,8546,3982,4564,1469,666,443,540
MSK,2,2009,19102,9673,9429,2060,255,478,981
MSK,2,2009,7847,3549,4298,1469,146,256,396
MSK,2,2009,8437,3927,4510,1144,281,311,590
MSK,2,2009,18081,8392,9689,2540,614,1023,992
PHA,3,2009,21284,10127,11157,5041,5649,9637,880
STC,3,2009,2068,942,1126,497,71,243,145
STC,3,2009,2512,1208,1304,502,287,879,161
STC,3,2009,6323,3195,3128,1148,338,547,428
STC,3,2009,3739,1899,1840,646,231,251,238
STC,3,2009,3349,1710,1639,533,215,308,186
STC,3,2009,3637,1944,1693,640,184,289,247
STC,3,2009,3306,1647,1659,676,203,208,161
STC,3,2009,3862,1850,2012,525,193,270,251
STC,3,2009,2028,1024,1004,603,502,921,77
STC,3,2009,1609,797,812,411,185,191,84
STC,3,2009,4748,2149,2599,805,163,205,278
STC,3,2009,2023,990,1033,419,126,131,148
JHC,3,2009,5215,2650,2565,1136,293,443,492
JHC,3,2009,3137,1521,1616,431,85,168,190
JHC,3,2009,3524,1782,1742,648,77,111,270
JHC,3,2009,2542,1261,1281,453,264,108,159
JHC,3,2009,1802,824,978,350,43,54,166
JHC,3,2009,2906,1421,1485,487,90,173,183
JHC,3,2009,3925,1970,1955,719,183,200,309
PLK,3,2009,2562,1312,1250,498,79,112,129
PLK,3,2009,3715,1857,1858,637,161,264,249
PLK,3,2009,5581,2927,2654,1173,859,1208,280
PLK,3,2009,1685,852,833,375,32,60,104
PLK,3,2009,2648,1417,1231,413,83,242,174
PLK,3,2009,1756,944,812,297,50,96,101
PLK,3,2009,3767,1860,1907,492,56,81,204
KVK,3,2009,4853,2162,2691,767,236,246,223
KVK,3,2009,6422,3050,3372,815,191,242,360
KVK,3,2009,5613,2754,2859,766,86,116,398
ULK,3,2009,9785,4846,4939,1131,153,152,524
ULK,3,2009,8087,4076,4011,1134,160,181,451
ULK,3,2009,5990,2964,3026,760,284,373,358
ULK,3,2009,5397,2659,2738,711,121,192,295
ULK,3,2009,9198,4747,4451,931,201,276,462
ULK,3,2009,7569,3927,3642,925,192,284,526
ULK,3,2009,7266,3563,3703,928,139,237,462
LBK,3,2009,6827,3397,3430,1228,198,166,328
LBK,3,2009,4136,2005,2131,558,75,108,270
LBK,3,2009,8038,3714,4324,1289,430,562,425
LBK,3,2009,3359,1565,1794,463,80,95,185
HKK,3,2009,4563,2190,2373,872,345,448,309
HKK,3,2009,3367,1625,1742,531,56,96,232
HKK,3,2009,3936,1883,2053,764,214,208,226
HKK,3,2009,2476,1219,1257,592,91,151,158
HKK,3,2009,5499,2692,2807,980,190,240,354
PAK,3,2009,4675,2123,2552,782,163,289,314
PAK,3,2009,4918,2330,2588,901,402,267,381
PAK,3,2009,5959,2861,3098,757,168,153,377
PAK,3,2009,6553,3001,3552,1189,303,312,451
VYS,3,2009,4471,2203,2268,602,102,118,292
VYS,3,2009,5465,2399,3066,861,240,239,391
VYS,3,2009,2668,1187,1481,509,155,114,161
VYS,3,2009,6333,3189,3144,812,152,136,490
VYS,3,2009,5128,2376,2752,630,125,205,374
JHM,3,2009,5032,2613,2419,878,89,136,333
JHM,3,2009,14762,7375,7387,2064,1434,2080,701
JHM,3,2009,6223,3215,3008,1081,177,243,400
JHM,3,2009,5862,2755,3107,975,426,309,437
JHM,3,2009,10581,4850,5731,1241,268,309,728
JHM,3,2009,3293,1496,1797,574,103,117,253
JHM,3,2009,7848,3964,3884,914,159,542,471
OLK,3,2009,3047,1274,1773,368,46,45,151
OLK,3,2009,10768,4735,6033,1641,674,601,718
OLK,3,2009,3888,2118,1770,803,156,148,217
OLK,3,2009,6885,3327,3558,1070,142,137,356
OLK,3,2009,7748,3621,4127,1260,353,238,462
ZLK,3,2009,5338,2525,2813,786,191,222,350
ZLK,3,2009,6103,3042,3061,932,105,195,277
ZLK,3,2009,7912,3600,4312,1010,338,416,569
ZLK,3,2009,7446,3665,3781,1280,268,287,598
MSK,3,2009,7355,3584,3771,904,137,121,416
MSK,3,2009,9003,4125,4878,1469,673,1040,528
MSK,3,2009,19606,9751,9855,2111,264,383,969
MSK,3,2009,8573,3803,4770,1402,386,266,406
MSK,3,2009,8783,4097,4686,1228,237,413,625
MSK,3,2009,19052,8666,10386,2695,707,902,990
PHA,4,2009,22268,10568,11700,4888,4496,6591,871
STC,4,2009,1984,936,1048,449,59,74,132
STC,4,2009,2551,1248,1303,452,124,189,157
STC,4,2009,6573,3323,3250,1075,153,295,425
STC,4,2009,3775,1958,1817,651,186,171,229
STC,4,2009,3197,1654,1543,442,129,138,178
STC,4,2009,3679,1946,1733,607,255,243,247
STC,4,2009,3338,1684,1654,591,222,200,156
STC,4,2009,3777,1866,1911,523,171,234,243
STC,4,2009,2142,1067,1075,552,217,576,78
STC,4,2009,1679,839,840,391,116,271,77
STC,4,2009,4868,2247,2621,852,254,198,302
STC,4,2009,1977,978,999,386,42,137,143
JHC,4,2009,5428,2783,2645,1129,360,319,497
JHC,4,2009,3171,1576,1595,593,113,85,183
JHC,4,2009,3232,1705,1527,529,82,137,264
JHC,4,2009,2442,1262,1180,457,182,256,140
JHC,4,2009,1781,855,926,338,72,69,160
JHC,4,2009,2989,1466,1523,502,93,106,199
JHC,4,2009,3990,2000,1990,729,146,153,311
PLK,4,2009,2633,1366,1267,431,59,90,136
PLK,4,2009,3522,1783,1739,612,160,190,242
PLK,4,2009,5897,3127,2770,1215,519,817,284
PLK,4,2009,1828,944,884,447,40,79,115
PLK,4,2009,2753,1475,1278,568,50,153,176
PLK,4,2009,1881,998,883,387,30,43,119
PLK,4,2009,3753,1890,1863,480,51,39,211
KVK,4,2009,4908,2263,2645,794,138,221,213
KVK,4,2009,6850,3298,3552,1182,341,257,380
KVK,4,2009,5979,3041,2938,1135,141,153,386
ULK,4,2009,9948,4969,4979,1301,147,168,523
ULK,4,2009,8719,4535,4184,1583,238,282,453
ULK,4,2009,5764,2963,2801,735,286,137,348
ULK,4,2009,5514,2759,2755,932,117,185,312
ULK,4,2009,9522,4945,4577,1195,106,182,484
ULK,4,2009,7550,3895,3655,920,189,196,497
ULK,4,2009,7582,3703,3879,1020,114,215,477
LBK,4,2009,7103,3580,3523,1047,317,102,333
LBK,4,2009,4305,2096,2209,612,144,130,289
LBK,4,2009,8426,3936,4490,1476,406,524,427
LBK,4,2009,3538,1677,1861,616,95,73,188
HKK,4,2009,4599,2227,2372,874,405,388,290
HKK,4,2009,3442,1647,1795,595,70,67,229
HKK,4,2009,3990,2002,1988,846,189,180,210
HKK,4,2009,2631,1332,1299,599,86,82,164
HKK,4,2009,5690,2833,2857,1008,221,244,375
PAK,4,2009,4594,2186,2408,751,167,217,315
PAK,4,2009,5024,2406,2618,1005,503,605,366
PAK,4,2009,5744,2793,2951,714,104,230,355
PAK,4,2009,6818,3228,3590,1107,222,306,434
VYS,4,2009,4528,2284,2244,589,62,97,289
VYS,4,2009,5265,2433,2832,709,133,130,357
VYS,4,2009,2687,1262,1425,520,58,119,159
VYS,4,2009,6022,3100,2922,716,80,100,485
VYS,4,2009,5067,2467,2600,744,122,123,354
JHM,4,2009,5212,2711,2501,816,86,66,325
JHM,4,2009,15325,7645,7680,2145,1553,1891,685
JHM,4,2009,6518,3341,3177,1211,207,245,394
JHM,4,2009,5670,2763,2907,883,272,429,438
JHM,4,2009,10461,4939,5522,1310,285,240,686
JHM,4,2009,3349,1573,1776,572,128,128,251
JHM,4,2009,7039,3636,3403,871,276,192,434
OLK,4,2009,2848,1227,1621,432,23,19,143
OLK,4,2009,11085,4887,6198,1915,427,699,725
OLK,4,2009,4091,2262,1829,851,158,137,210
OLK,4,2009,7128,3486,3642,1152,146,157,358
OLK,4,2009,8046,3791,4255,1249,156,249,461
ZLK,4,2009,5446,2657,2789,838,151,158,345
ZLK,4,2009,6249,3187,3062,1012,115,224,268
ZLK,4,2009,8205,3739,4466,1173,382,405,584
ZLK,4,2009,7777,3834,3943,1372,260,333,599
MSK,4,2009,7328,3648,3680,1015,126,127,427
MSK,4,2009,9233,4298,4935,1610,382,402,533
MSK,4,2009,19707,9733,9974,2081,299,285,957
MSK,4,2009,8930,4025,4905,1406,274,327,397
MSK,4,2009,8745,4127,4618,1140,189,190,613
MSK,4,2009,19417,8851,10566,2397,894,797,948
PHA,5,2009,23114,11013,12101,4385,4103,5060,798
STC,5,2009,1957,945,1012,375,75,45,112
STC,5,2009,2589,1283,1306,370,354,325,137
STC,5,2009,6572,3351,3221,771,175,180,375
STC,5,2009,3786,1989,1797,548,186,172,193
STC,5,2009,3105,1648,1457,377,215,163,154
STC,5,2009,3726,1969,1757,529,101,257,211
STC,5,2009,3255,1662,1593,445,201,244,146
STC,5,2009,3789,1901,1888,466,307,377,224
STC,5,2009,2169,1066,1103,440,127,495,58
STC,5,2009,1766,877,889,358,77,53,71
STC,5,2009,4881,2318,2563,624,232,289,276
STC,5,2009,1927,961,966,269,52,64,131
JHC,5,2009,5366,2785,2581,797,304,300,437
JHC,5,2009,3000,1496,1504,380,95,129,166
JHC,5,2009,3062,1659,1403,426,65,68,207
JHC,5,2009,2412,1288,1124,354,291,102,117
JHC,5,2009,1692,855,837,265,71,58,139
JHC,5,2009,2941,1489,1452,340,99,79,163
JHC,5,2009,4038,2058,1980,518,160,107,256
PLK,5,2009,2686,1404,1282,355,37,52,127
PLK,5,2009,3406,1740,1666,446,129,196,207
PLK,5,2009,6110,3268,2842,995,352,672,268
PLK,5,2009,1885,997,888,285,34,18,105
PLK,5,2009,2804,1522,1282,410,82,78,154
PLK,5,2009,1860,986,874,240,27,8,112
PLK,5,2009,3829,1972,1857,451,27,47,194
KVK,5,2009,4892,2231,2661,605,108,128,192
KVK,5,2009,6831,3384,3447,815,242,350,343
KVK,5,2009,5901,3029,2872,583,86,92,369
ULK,5,2009,9790,4932,4858,890,85,147,491
ULK,5,2009,8857,4570,4287,1052,240,249,396
ULK,5,2009,5730,2965,2765,672,208,237,306
ULK,5,2009,5550,2767,2783,634,108,207,296
ULK,5,2009,9341,4862,4479,758,172,100,431
ULK,5,2009,7565,3938,3627,735,184,192,467
ULK,5,2009,7670,3742,3928,781,112,174,447
LBK,5,2009,7249,3707,3542,849,181,230,295
LBK,5,2009,4371,2125,2246,505,98,128,270
LBK,5,2009,8468,4085,4383,1059,336,490,412
LBK,5,2009,3499,1718,1781,415,42,67,174
HKK,5,2009,4555,2254,2301,654,340,349,255
HKK,5,2009,3380,1673,1707,436,49,57,206
HKK,5,2009,3982,2020,1962,689,179,216,188
HKK,5,2009,2647,1340,1307,442,85,68,148
HKK,5,2009,5672,2899,2773,754,200,208,352
PAK,5,2009,4413,2177,2236,534,112,104,267
PAK,5,2009,5094,2489,2605,839,226,140,333
PAK,5,2009,5590,2798,2792,553,218,153,310
PAK,5,2009,6750,3295,3455,775,217,175,368
VYS,5,2009,4616,2368,2248,577,70,106,264
VYS,5,2009,5171,2455,2716,603,142,160,316
VYS,5,2009,2649,1298,1351,371,40,36,132
VYS,5,2009,5914,3108,2806,653,106,111,407
VYS,5,2009,4980,2492,2488,570,114,145,297
JHM,5,2009,5267,2738,2529,615,29,69,274
JHM,5,2009,15769,7874,7895,1848,1447,884,641
JHM,5,2009,6613,3417,3196,925,124,338,347
JHM,5,2009,5430,2681,2749,603,239,242,379
JHM,5,2009,10148,4834,5314,901,177,170,587
JHM,5,2009,3370,1638,1732,444,88,143,227
JHM,5,2009,6684,3468,3216,641,136,196,396
OLK,5,2009,2641,1192,1449,310,19,23,138
OLK,5,2009,11477,5068,6409,1587,430,382,639
OLK,5,2009,4048,2242,1806,629,72,104,176
OLK,5,2009,7152,3555,3597,820,154,115,328
OLK,5,2009,8043,3868,4175,825,133,224,411
ZLK,5,2009,5516,2715,2801,649,166,219,296
ZLK,5,2009,6275,3233,3042,751,124,96,240
ZLK,5,2009,8253,3836,4417,990,248,252,486
ZLK,5,2009,8001,4004,3997,1042,190,153,516
MSK,5,2009,7215,3668,3547,714,130,130,362
MSK,5,2009,9374,4409,4965,1364,346,386,452
MSK,5,2009,20114,9859,10255,1938,263,258,860
MSK,5,2009,9131,4130,5001,1131,216,238,354
MSK,5,2009,8591,4144,4447,920,204,243,543
MSK,5,2009,19595,8974,10621,2018,716,870,843
PHA,6,2009,23984,11599,12385,4664,3365,5285,757
STC,6,2009,1969,972,997,383,190,194,117
STC,6,2009,2666,1322,1344,438,213,269,123
STC,6,2009,6770,3440,3330,951,186,254,355
STC,6,2009,3781,2011,1770,539,171,201,165
STC,6,2009,3147,1687,1460,426,139,169,140
STC,6,2009,3762,2003,1759,531,97,207,176
STC,6,2009,3156,1638,1518,461,192,187,126
STC,6,2009,3836,1942,1894,476,174,152,186
STC,6,2009,2183,1111,1072,421,314,360,59
STC,6,2009,1842,907,935,377,110,176,52
STC,6,2009,4891,2336,2555,610,208,241,233
STC,6,2009,1997,992,1005,299,42,66,119
JHC,6,2009,5394,2868,2526,895,273,286,384
JHC,6,2009,2883,1462,1421,349,70,108,130
JHC,6,2009,3013,1667,1346,450,81,87,157
JHC,6,2009,2351,1273,1078,392,104,190,111
JHC,6,2009,1683,897,786,313,84,90,120
JHC,6,2009,2988,1544,1444,436,72,69,119
JHC,6,2009,4277,2172,2105,707,147,210,228
PLK,6,2009,2830,1470,1360,443,38,46,97
PLK,6,2009,3376,1782,1594,484,133,236,174
PLK,6,2009,6330,3373,2957,1031,662,485,241
PLK,6,2009,1944,1054,890,308,44,59,92
PLK,6,2009,2774,1547,1227,382,50,52,125
PLK,6,2009,1886,1011,875,237,38,48,97
PLK,6,2009,3807,1963,1844,391,43,64,151
KVK,6,2009,4964,2288,2676,654,118,181,170
KVK,6,2009,6793,3355,3438,740,179,223,318
KVK,6,2009,5896,3017,2879,690,87,78,314
ULK,6,2009,9676,4948,4728,929,114,127,412
ULK,6,2009,8534,4384,4150,992,183,193,323
ULK,6,2009,5875,3076,2799,722,202,303,273
ULK,6,2009,5402,2701,2701,643,175,163,260
ULK,6,2009,9416,4932,4484,949,186,308,369
ULK,6,2009,7524,3896,3628,778,226,181,397
ULK,6,2009,7812,3856,3956,903,122,131,375
LBK,6,2009,7204,3739,3465,694,266,182,242
LBK,6,2009,4530,2229,2301,631,99,97,230
LBK,6,2009,8625,4248,4377,1182,355,297,372
LBK,6,2009,3540,1786,1754,454,57,55,139
HKK,6,2009,4671,2315,2356,775,380,444,271
HKK,6,2009,3354,1687,1667,411,93,87,159
HKK,6,2009,3973,2018,1955,662,99,140,151
HKK,6,2009,2652,1361,1291,406,89,104,128
HKK,6,2009,5708,2919,2789,744,254,230,283
PAK,6,2009,4492,2268,2224,630,236,621,245
PAK,6,2009,5204,2622,2582,856,304,284,293
PAK,6,2009,5568,2806,2762,592,192,180,248
PAK,6,2009,6699,3341,3358,823,261,261,331
VYS,6,2009,4702,2446,2256,567,70,69,225
VYS,6,2009,5185,2462,2723,665,105,112,250
VYS,6,2009,2702,1350,1352,422,53,95,112
VYS,6,2009,5888,3106,2782,685,68,164,339
VYS,6,2009,5221,2660,2561,774,85,138,243
JHM,6,2009,5471,2854,2617,713,118,101,237
JHM,6,2009,16212,8107,8105,1990,832,1454,560
JHM,6,2009,6831,3558,3273,979,150,148,316
JHM,6,2009,5535,2790,2745,796,170,215,333
JHM,6,2009,10308,4946,5362,1206,164,176,507
JHM,6,2009,3444,1713,1731,517,85,90,203
JHM,6,2009,6581,3506,3075,763,205,222,324
OLK,6,2009,2460,1158,1302,305,23,21,115
OLK,6,2009,11797,5241,6556,1529,349,461,549
OLK,6,2009,4205,2367,1838,682,91,91,146
OLK,6,2009,7319,3654,3665,889,191,178,288
OLK,6,2009,8110,3917,4193,859,157,285,334
ZLK,6,2009,5675,2768,2907,760,84,181,241
ZLK,6,2009,6411,3324,3087,829,73,158,194
ZLK,6,2009,8373,3931,4442,922,279,309,380
ZLK,6,2009,8263,4133,4130,1141,304,261,397
MSK,6,2009,7169,3668,3501,662,113,175,304
MSK,6,2009,9596,4587,5009,1366,399,355,396
MSK,6,2009,20497,9995,10502,2050,192,247,736
MSK,6,2009,9230,4241,4989,1043,174,234,290
MSK,6,2009,8720,4277,4443,1096,213,223,497
MSK,6,2009,20018,9164,10854,2274,686,978,677
PHA,7,2009,25957,12834,13123,5255,2941,4130,827
STC,7,2009,2204,1147,1057,550,52,55,128
STC,7,2009,2789,1401,1388,478,256,267,122
STC,7,2009,7055,3629,3426,988,170,151,376
STC,7,2009,3999,2146,1853,680,268,299,146
STC,7,2009,3291,1801,1490,505,123,137,139
STC,7,2009,3947,2153,1794,634,143,183,181
STC,7,2009,3290,1734,1556,513,163,114,119
STC,7,2009,4031,2065,1966,571,89,123,175
STC,7,2009,2356,1220,1136,583,412,311,47
STC,7,2009,2053,1017,1036,479,81,46,53
STC,7,2009,5067,2466,2601,727,144,166,250
STC,7,2009,2162,1098,1064,416,42,58,138
JHC,7,2009,5769,3112,2657,1074,224,224,430
JHC,7,2009,2939,1529,1410,426,77,55,138
JHC,7,2009,3172,1841,1331,596,81,72,163
JHC,7,2009,2368,1310,1058,417,59,111,108
JHC,7,2009,1650,898,752,281,74,70,128
JHC,7,2009,3136,1657,1479,437,65,86,130
JHC,7,2009,4259,2221,2038,566,161,150,254
PLK,7,2009,3024,1573,1451,481,86,34,99
PLK,7,2009,3626,1923,1703,605,87,124,193
PLK,7,2009,6786,3613,3173,1229,889,658,231
PLK,7,2009,2101,1155,946,414,45,94,98
PLK,7,2009,2936,1652,1284,514,60,78,112
PLK,7,2009,2052,1043,1009,383,44,47,106
PLK,7,2009,3969,2053,1916,479,32,30,156
KVK,7,2009,5113,2375,2738,701,149,119,171
KVK,7,2009,6909,3436,3473,798,171,296,303
KVK,7,2009,6002,3106,2896,690,80,65,327
ULK,7,2009,9852,5095,4757,1056,127,126,392
ULK,7,2009,8739,4485,4254,989,100,117,314
ULK,7,2009,5918,3149,2769,744,157,112,255
ULK,7,2009,5567,2798,2769,715,109,139,263
ULK,7,2009,9717,5136,4581,1038,228,286,401
ULK,7,2009,7775,4036,3739,952,176,197,392
ULK,7,2009,7973,3941,4032,856,133,106,369
LBK,7,2009,7253,3830,3423,775,109,164,241
LBK,7,2009,4778,2396,2382,620,122,153,243
LBK,7,2009,8986,4554,4432,1316,446,390,388
LBK,7,2009,3627,1853,1774,463,85,83,140
HKK,7,2009,5144,2598,2546,1059,242,348,315
HKK,7,2009,3437,1757,1680,474,44,49,165
HKK,7,2009,4275,2191,2084,859,204,129,162
HKK,7,2009,2809,1477,1332,558,55,59,129
HKK,7,2009,5852,3011,2841,813,234,315,281
PAK,7,2009,4736,2449,2287,784,255,250,275
PAK,7,2009,5622,2914,2708,1088,219,262,340
PAK,7,2009,5941,3027,2914,844,214,353,285
PAK,7,2009,6951,3538,3413,993,250,209,367
VYS,7,2009,4929,2599,2330,625,55,69,245
VYS,7,2009,5465,2655,2810,830,164,127,252
VYS,7,2009,2879,1500,1379,467,71,72,144
VYS,7,2009,6308,3369,2939,884,75,86,396
VYS,7,2009,5586,2935,2651,853,121,81,276
JHM,7,2009,5794,3053,2741,813,46,57,264
JHM,7,2009,16983,8667,8316,2287,949,999,579
JHM,7,2009,7299,3839,3460,1204,165,104,359
JHM,7,2009,5820,2981,2839,888,163,189,353
JHM,7,2009,10742,5284,5458,1317,146,169,539
JHM,7,2009,3665,1849,1816,532,65,61,210
JHM,7,2009,6615,3506,3109,800,103,159,319
OLK,7,2009,2394,1161,1233,361,26,28,111
OLK,7,2009,12601,5748,6853,2214,346,355,601
OLK,7,2009,4519,2567,1952,763,157,124,145
OLK,7,2009,7806,3967,3839,1030,101,219,327
OLK,7,2009,8716,4236,4480,1258,222,250,387
ZLK,7,2009,6066,3017,3049,905,128,273,260
ZLK,7,2009,6656,3520,3136,891,75,68,201
ZLK,7,2009,8872,4269,4603,1144,202,204,416
ZLK,7,2009,8893,4515,4378,1393,174,151,452
MSK,7,2009,7429,3842,3587,815,139,89,319
MSK,7,2009,10005,4865,5140,1484,450,475,447
MSK,7,2009,21025,10353,10672,2114,235,270,809
MSK,7,2009,9616,4427,5189,1312,227,213,304
MSK,7,2009,9031,4469,4562,1144,159,162,511
MSK,7,2009,20641,9647,10994,2428,595,521,688
PHA,8,2009,27247,13662,13585,4668,2766,4048,953
STC,8,2009,2335,1205,1130,510,60,105,195
STC,8,2009,2921,1466,1455,469,150,190,158
STC,8,2009,7199,3706,3493,894,142,133,442
STC,8,2009,4138,2239,1899,555,187,183,144
STC,8,2009,3406,1844,1562,430,181,91,165
STC,8,2009,4119,2247,1872,598,94,201,252
STC,8,2009,3402,1791,1611,496,183,246,124
STC,8,2009,4173,2130,2043,543,148,174,221
STC,8,2009,2472,1294,1178,457,136,187,52
STC,8,2009,2199,1113,1086,382,87,106,73
STC,8,2009,5146,2518,2628,645,142,191,343
STC,8,2009,2154,1098,1056,261,91,73,121
JHC,8,2009,5772,3182,2590,901,273,286,450
JHC,8,2009,3051,1568,1483,434,95,153,164
JHC,8,2009,3223,1889,1334,429,121,90,185
JHC,8,2009,2398,1339,1059,372,85,84,171
JHC,8,2009,1646,887,759,274,97,59,152
JHC,8,2009,3123,1620,1503,348,135,92,151
JHC,8,2009,4284,2268,2016,504,126,153,267
PLK,8,2009,3112,1640,1472,407,82,75,111
PLK,8,2009,3705,2006,1699,500,110,108,263
PLK,8,2009,7043,3760,3283,1048,672,505,243
PLK,8,2009,2110,1156,954,287,34,36,140
PLK,8,2009,2970,1689,1281,427,62,88,132
PLK,8,2009,2131,1095,1036,295,24,33,119
PLK,8,2009,4178,2182,1996,629,37,39,160
KVK,8,2009,5013,2306,2707,484,244,106,171
KVK,8,2009,6895,3403,3492,705,264,274,364
KVK,8,2009,6058,3149,2909,702,44,79,375
ULK,8,2009,9925,5157,4768,959,65,19,442
ULK,8,2009,8994,4593,4401,1125,130,161,412
ULK,8,2009,6034,3251,2783,736,291,189,299
ULK,8,2009,5520,2802,2718,569,56,72,283
ULK,8,2009,9836,5249,4587,899,139,125,466
ULK,8,2009,7957,4139,3818,896,245,232,502
ULK,8,2009,8122,3997,4125,816,163,144,398
LBK,8,2009,7022,3707,3315,563,189,192,261
LBK,8,2009,4938,2500,2438,610,83,60,250
LBK,8,2009,9159,4706,4453,1163,517,513,464
LBK,8,2009,3639,1867,1772,368,98,49,166
HKK,8,2009,5278,2685,2593,788,533,277,403
HKK,8,2009,3556,1830,1726,458,51,55,214
HKK,8,2009,4238,2209,2029,585,117,113,194
HKK,8,2009,2839,1507,1332,412,87,87,172
HKK,8,2009,5802,2950,2852,636,240,242,312
PAK,8,2009,4792,2506,2286,582,135,95,336
PAK,8,2009,5859,3027,2832,882,349,188,418
PAK,8,2009,5967,3034,2933,614,255,336,347
PAK,8,2009,6938,3574,3364,762,245,265,409
VYS,8,2009,4971,2624,2347,494,73,86,293
VYS,8,2009,5595,2755,2840,593,252,223,314
VYS,8,2009,2932,1563,1369,418,64,27,201
VYS,8,2009,6439,3425,3014,666,134,79,468
VYS,8,2009,5825,3014,2811,749,149,132,382
JHM,8,2009,5920,3101,2819,681,92,72,356
JHM,8,2009,17378,8920,8458,1850,940,1076,639
JHM,8,2009,7659,4005,3654,1075,258,142,489
JHM,8,2009,5858,2995,2863,675,166,146,477
JHM,8,2009,11039,5413,5626,1139,204,146,730
JHM,8,2009,3838,1950,1888,530,78,79,288
JHM,8,2009,6816,3629,3187,770,165,158,438
OLK,8,2009,2360,1155,1205,260,37,10,125
OLK,8,2009,12766,5883,6883,1365,413,384,781
OLK,8,2009,4642,2672,1970,647,174,167,167
OLK,8,2009,7997,4097,3900,791,101,92,426
OLK,8,2009,8781,4273,4508,805,120,127,498
ZLK,8,2009,6155,3042,3113,675,128,173,266
ZLK,8,2009,6771,3597,3174,755,94,100,217
ZLK,8,2009,8867,4291,4576,809,386,390,547
ZLK,8,2009,9134,4674,4460,1046,164,274,574
MSK,8,2009,7475,3902,3573,652,101,143,380
MSK,8,2009,10087,4981,5106,1245,318,318,643
MSK,8,2009,21144,10492,10652,1785,313,327,1026
MSK,8,2009,9536,4441,5095,892,297,233,346
MSK,8,2009,9111,4530,4581,930,175,144,635
MSK,8,2009,20617,9667,10950,2028,721,593,809
PHA,9,2009,27979,13991,13988,6007,2972,3818,1436
STC,9,2009,2524,1286,1238,716,74,69,321
STC,9,2009,2969,1469,1500,553,150,181,195
STC,9,2009,7191,3636,3555,1150,150,190,611
STC,9,2009,4279,2257,2022,819,216,186,183
STC,9,2009,3496,1858,1638,643,138,128,208
STC,9,2009,4288,2313,1975,765,137,119,380
STC,9,2009,3480,1823,1657,670,124,189,180
STC,9,2009,4264,2157,2107,659,88,103,223
STC,9,2009,2654,1391,1263,708,177,250,178
STC,9,2009,2325,1179,1146,588,124,46,177
STC,9,2009,5175,2507,2668,910,154,139,545
STC,9,2009,2197,1113,1084,445,45,76,223
JHC,9,2009,5820,3181,2639,1293,264,231,633
JHC,9,2009,3174,1615,1559,592,50,42,266
JHC,9,2009,3270,1926,1344,674,77,127,351
JHC,9,2009,2439,1341,1098,532,104,112,241
JHC,9,2009,1633,860,773,397,83,134,197
JHC,9,2009,3141,1604,1537,561,55,88,184
JHC,9,2009,4371,2330,2041,810,150,165,387
PLK,9,2009,3109,1621,1488,442,53,126,200
PLK,9,2009,3749,2029,1720,627,146,146,345
PLK,9,2009,7093,3760,3333,1336,403,768,327
PLK,9,2009,2149,1154,995,431,102,69,220
PLK,9,2009,3093,1749,1344,666,42,78,237
PLK,9,2009,2120,1096,1024,349,51,24,141
PLK,9,2009,4213,2190,2023,581,51,60,284
KVK,9,2009,5078,2352,2726,752,107,220,222
KVK,9,2009,6879,3339,3540,952,161,167,490
KVK,9,2009,6203,3183,3020,943,79,63,557
ULK,9,2009,10044,5232,4812,1220,90,86,651
ULK,9,2009,9068,4600,4468,1307,229,194,608
ULK,9,2009,6242,3316,2926,1031,86,160,438
ULK,9,2009,5657,2847,2810,865,84,75,402
ULK,9,2009,9990,5303,4687,1161,95,110,641
ULK,9,2009,8189,4229,3960,1154,181,201,720
ULK,9,2009,8261,3999,4262,1069,162,168,573
LBK,9,2009,7031,3683,3348,936,149,225,447
LBK,9,2009,5039,2548,2491,800,128,77,279
LBK,9,2009,9126,4672,4454,1450,401,414,567
LBK,9,2009,3683,1911,1772,566,111,90,240
HKK,9,2009,5292,2691,2601,997,421,571,572
HKK,9,2009,3579,1841,1738,589,65,48,331
HKK,9,2009,4206,2113,2093,808,155,292,311
HKK,9,2009,2894,1523,1371,585,64,73,257
HKK,9,2009,5854,2978,2876,974,260,245,511
PAK,9,2009,4922,2553,2369,886,172,172,544
PAK,9,2009,6143,3141,3002,1338,255,464,595
PAK,9,2009,6010,3006,3004,869,190,159,520
PAK,9,2009,6985,3549,3436,1142,208,199,583
VYS,9,2009,4879,2565,2314,656,83,64,450
VYS,9,2009,5791,2756,3035,1119,124,168,532
VYS,9,2009,2809,1495,1314,450,37,92,252
VYS,9,2009,6612,3432,3180,1083,99,151,684
VYS,9,2009,5779,2899,2880,882,72,156,581
JHM,9,2009,5957,3025,2932,874,103,117,543
JHM,9,2009,17631,8942,8689,2658,1062,992,655
JHM,9,2009,7943,4086,3857,1518,111,227,811
JHM,9,2009,5934,3009,2925,1053,170,175,672
JHM,9,2009,11207,5458,5749,1401,134,161,989
JHM,9,2009,4007,1995,2012,745,67,79,496
JHM,9,2009,6808,3546,3262,1070,159,226,654
OLK,9,2009,2415,1207,1208,416,23,24,210
OLK,9,2009,12995,5955,7040,2085,379,356,1075
OLK,9,2009,5097,2821,2276,1183,146,183,377
OLK,9,2009,8117,4102,4015,1054,120,121,632
OLK,9,2009,8771,4235,4536,1150,154,157,623
ZLK,9,2009,6332,3092,3240,963,140,124,555
ZLK,9,2009,6928,3597,3331,1167,112,165,371
ZLK,9,2009,8977,4305,4672,1188,223,253,765
ZLK,9,2009,9346,4695,4651,1549,247,254,815
MSK,9,2009,7552,3951,3601,949,140,152,580
MSK,9,2009,10136,5031,5105,1641,365,288,898
MSK,9,2009,21040,10456,10584,2324,364,251,1328
MSK,9,2009,9498,4450,5048,1270,240,244,422
MSK,9,2009,9226,4580,4646,1383,206,215,869
MSK,9,2009,20455,9583,10872,2676,745,779,1255
PHA,10,2009,28183,14072,14111,4998,2936,3784,1685
STC,10,2009,2568,1285,1283,488,67,77,307
STC,10,2009,3001,1452,1549,475,142,97,181
STC,10,2009,7213,3642,3571,984,235,299,615
STC,10,2009,4312,2288,2024,612,189,181,187
STC,10,2009,3443,1820,1623,439,104,141,211
STC,10,2009,4353,2349,2004,585,100,152,389
STC,10,2009,3540,1825,1715,568,170,216,194
STC,10,2009,4284,2136,2148,553,103,144,333
STC,10,2009,2741,1416,1325,540,133,183,215
STC,10,2009,2380,1206,1174,438,76,110,198
STC,10,2009,5228,2541,2687,698,210,204,521
STC,10,2009,2249,1135,1114,339,55,54,247
JHC,10,2009,5776,3103,2673,936,293,440,601
JHC,10,2009,3220,1655,1565,466,37,48,266
JHC,10,2009,3407,1993,1414,613,84,99,360
JHC,10,2009,2416,1322,1094,370,93,212,230
JHC,10,2009,1670,869,801,348,68,77,182
JHC,10,2009,3063,1577,1486,348,60,120,172
JHC,10,2009,4558,2366,2192,722,115,158,400
PLK,10,2009,3016,1606,1410,334,35,46,191
PLK,10,2009,3816,2049,1767,577,175,154,323
PLK,10,2009,7084,3704,3380,993,489,706,345
PLK,10,2009,2137,1120,1017,321,64,99,226
PLK,10,2009,3072,1727,1345,434,66,96,233
PLK,10,2009,2010,1059,951,238,50,44,125
PLK,10,2009,4101,2125,1976,382,52,42,270
KVK,10,2009,5052,2321,2731,627,83,72,242
KVK,10,2009,6968,3333,3635,791,155,221,499
KVK,10,2009,6192,3134,3058,704,57,73,547
ULK,10,2009,10011,5191,4820,931,80,157,661
ULK,10,2009,8815,4417,4398,922,121,212,589
ULK,10,2009,6210,3290,2920,695,144,132,424
ULK,10,2009,5629,2811,2818,650,42,45,380
ULK,10,2009,9877,5208,4669,829,128,104,612
ULK,10,2009,8213,4235,3978,845,104,113,714
ULK,10,2009,8092,3858,4234,723,186,186,567
LBK,10,2009,7034,3646,3388,765,142,187,476
LBK,10,2009,5107,2601,2506,628,72,127,318
LBK,10,2009,9054,4690,4364,1088,376,427,578
LBK,10,2009,3671,1866,1805,395,54,77,274
HKK,10,2009,5257,2657,2600,790,397,406,598
HKK,10,2009,3446,1781,1665,404,74,97,309
HKK,10,2009,4185,2067,2118,637,148,141,303
HKK,10,2009,2864,1517,1347,410,57,93,257
HKK,10,2009,5719,2879,2840,734,328,312,485
PAK,10,2009,4841,2448,2393,622,132,123,505
PAK,10,2009,6107,3103,3004,905,304,346,594
PAK,10,2009,5945,2965,2980,538,133,162,507
PAK,10,2009,7072,3561,3511,953,278,330,551
VYS,10,2009,4663,2479,2184,439,66,116,420
VYS,10,2009,5772,2723,3049,642,115,262,541
VYS,10,2009,2644,1397,1247,318,37,49,262
VYS,10,2009,6644,3430,3214,663,128,123,646
VYS,10,2009,5800,2925,2875,637,95,105,564
JHM,10,2009,5854,2932,2922,594,62,80,517
JHM,10,2009,17475,8797,8678,1824,1135,1095,953
JHM,10,2009,7851,3993,3858,916,118,253,767
JHM,10,2009,5886,2945,2941,699,190,203,618
JHM,10,2009,11045,5366,5679,972,140,174,949
JHM,10,2009,4044,1972,2072,478,61,59,476
JHM,10,2009,7323,3802,3521,1229,119,235,640
OLK,10,2009,2464,1246,1218,319,17,17,195
OLK,10,2009,12957,5907,7050,1556,418,340,1070
OLK,10,2009,5193,2845,2348,694,84,91,375
OLK,10,2009,8049,4029,4020,784,51,83,621
OLK,10,2009,8630,4172,4458,719,154,142,608
ZLK,10,2009,6270,3056,3214,568,86,135,560
ZLK,10,2009,6893,3590,3303,724,82,166,380
ZLK,10,2009,9005,4265,4740,904,203,214,725
ZLK,10,2009,9219,4587,4632,906,221,236,774
MSK,10,2009,7530,3863,3667,772,197,139,567
MSK,10,2009,10052,4967,5085,1226,407,412,862
MSK,10,2009,20667,10363,10304,1662,343,322,1237
MSK,10,2009,9293,4334,4959,942,158,227,406
MSK,10,2009,9210,4499,4711,962,199,203,832
MSK,10,2009,20125,9506,10619,2029,916,1032,1193
PHA,11,2009,28973,14209,14764,5088,3067,4015,1665
STC,11,2009,2643,1329,1314,465,75,90,293
STC,11,2009,3077,1451,1626,459,113,271,174
STC,11,2009,7292,3624,3668,925,137,114,586
STC,11,2009,4410,2311,2099,620,184,269,174
STC,11,2009,3518,1837,1681,494,84,134,206
STC,11,2009,4363,2340,2023,581,97,127,364
STC,11,2009,3624,1831,1793,539,156,112,190
STC,11,2009,4368,2192,2176,567,324,286,327
STC,11,2009,2739,1408,1331,464,190,297,187
STC,11,2009,2458,1201,1257,440,80,43,185
STC,11,2009,5478,2548,2930,816,136,231,491
STC,11,2009,2324,1148,1176,322,50,53,228
JHC,11,2009,5934,3135,2799,941,249,207,580
JHC,11,2009,3472,1786,1686,617,48,29,244
JHC,11,2009,3586,2047,1539,628,64,86,330
JHC,11,2009,2538,1351,1187,461,58,73,206
JHC,11,2009,1806,920,886,394,58,59,169
JHC,11,2009,3151,1597,1554,425,70,97,163
JHC,11,2009,4864,2399,2465,782,103,119,387
PLK,11,2009,3070,1615,1455,362,103,91,176
PLK,11,2009,4041,2144,1897,684,98,156,314
PLK,11,2009,7081,3663,3418,914,486,707,322
PLK,11,2009,2157,1143,1014,309,16,52,208
PLK,11,2009,3057,1679,1378,410,42,83,219
PLK,11,2009,2012,1075,937,233,24,43,112
PLK,11,2009,4096,2112,1984,408,58,65,237
KVK,11,2009,5063,2322,2741,567,96,163,230
KVK,11,2009,7028,3314,3714,739,172,166,464
KVK,11,2009,6260,3119,3141,675,54,58,506
ULK,11,2009,10211,5250,4961,1065,104,100,646
ULK,11,2009,8831,4409,4422,887,112,120,553
ULK,11,2009,6387,3316,3071,803,121,162,411
ULK,11,2009,5936,2924,3012,907,116,89,376
ULK,11,2009,9769,5127,4642,824,143,267,560
ULK,11,2009,8312,4236,4076,843,107,136,662
ULK,11,2009,8057,3781,4276,759,166,181,532
LBK,11,2009,7059,3649,3410,725,176,141,455
LBK,11,2009,5178,2599,2579,553,95,66,317
LBK,11,2009,9202,4699,4503,1143,281,376,566
LBK,11,2009,3786,1874,1912,475,101,111,257
HKK,11,2009,5399,2675,2724,908,314,255,559
HKK,11,2009,3509,1741,1768,491,60,72,303
HKK,11,2009,4253,2044,2209,654,137,184,279
HKK,11,2009,2853,1474,1379,405,58,73,245
HKK,11,2009,5795,2843,2952,835,244,269,438
PAK,11,2009,5052,2504,2548,798,124,116,483
PAK,11,2009,6185,3061,3124,883,272,294,574
PAK,11,2009,6203,2994,3209,770,199,222,481
PAK,11,2009,7209,3571,3638,853,211,203,525
VYS,11,2009,4739,2495,2244,622,51,82,405
VYS,11,2009,5831,2720,3111,715,137,116,528
VYS,11,2009,2741,1407,1334,421,57,28,262
VYS,11,2009,6994,3487,3507,984,92,97,650
VYS,11,2009,6013,2968,3045,749,88,91,536
JHM,11,2009,5845,2875,2970,586,74,93,491
JHM,11,2009,17623,8803,8820,1889,919,1303,909
JHM,11,2009,8023,4016,4007,1079,284,149,724
JHM,11,2009,6394,3125,3269,1113,163,172,614
JHM,11,2009,11352,5431,5921,1184,194,218,911
JHM,11,2009,4198,2028,2170,586,71,69,441
JHM,11,2009,7853,4024,3829,1241,164,139,645
OLK,11,2009,2814,1362,1452,571,38,24,192
OLK,11,2009,13239,5976,7263,1642,337,372,1024
OLK,11,2009,5406,2912,2494,736,122,94,381
OLK,11,2009,8124,4005,4119,779,111,105,599
OLK,11,2009,8692,4136,4556,934,136,104,573
ZLK,11,2009,6410,3017,3393,680,119,171,540
ZLK,11,2009,7103,3621,3482,829,264,88,375
ZLK,11,2009,9150,4224,4926,897,159,232,702
ZLK,11,2009,9253,4608,4645,1051,138,249,705
MSK,11,2009,7733,3897,3836,942,87,127,525
MSK,11,2009,10244,4991,5253,1359,260,311,798
MSK,11,2009,20545,10273,10272,1754,144,287,1143
MSK,11,2009,9679,4408,5271,1349,208,212,394
MSK,11,2009,9273,4441,4832,1017,133,198,777
MSK,11,2009,19969,9367,10602,2017,515,713,1117
PHA,12,2009,29865,14491,15374,4319,2463,2774,1601
STC,12,2009,2858,1385,1473,554,84,63,256
STC,12,2009,3164,1497,1667,402,111,72,170
STC,12,2009,7476,3669,3807,815,81,129,573
STC,12,2009,4745,2404,2341,708,79,191,162
STC,12,2009,3800,1890,1910,625,57,85,196
STC,12,2009,4615,2444,2171,599,93,110,345
STC,12,2009,3857,1921,1936,566,64,84,187
STC,12,2009,4619,2260,2359,587,65,80,335
STC,12,2009,2859,1433,1426,466,183,334,172
STC,12,2009,2504,1198,1306,356,110,238,172
STC,12,2009,6074,2683,3391,1042,131,175,475
STC,12,2009,2573,1253,1320,431,56,68,227
JHC,12,2009,6209,3188,3021,969,198,177,577
JHC,12,2009,3730,1824,1906,576,66,70,242
JHC,12,2009,4059,2100,1959,880,43,42,345
JHC,12,2009,3007,1519,1488,744,89,54,202
JHC,12,2009,2034,973,1061,421,58,71,167
JHC,12,2009,3416,1642,1774,513,42,69,160
JHC,12,2009,5075,2432,2643,697,65,101,391
PLK,12,2009,3203,1618,1585,397,26,45,171
PLK,12,2009,4383,2137,2246,779,95,82,311
PLK,12,2009,7243,3685,3558,935,252,339,313
PLK,12,2009,2285,1197,1088,352,40,23,204
PLK,12,2009,3197,1678,1519,445,53,37,218
PLK,12,2009,2146,1127,1019,295,37,18,104
PLK,12,2009,4345,2154,2191,533,7,10,243
KVK,12,2009,5468,2506,2962,830,72,133,251
KVK,12,2009,7366,3446,3920,854,93,125,470
KVK,12,2009,6503,3185,3318,715,96,68,490
ULK,12,2009,10647,5330,5317,1062,68,62,643
ULK,12,2009,9114,4538,4576,989,67,100,532
ULK,12,2009,7048,3539,3509,1116,74,108,403
ULK,12,2009,6147,2931,3216,741,39,49,366
ULK,12,2009,9899,5166,4733,740,120,129,546
ULK,12,2009,8801,4451,4350,1001,97,107,644
ULK,12,2009,8320,3822,4498,788,91,131,523
LBK,12,2009,7250,3709,3541,781,82,170,449
LBK,12,2009,5379,2646,2733,569,72,90,317
LBK,12,2009,9692,4833,4859,1217,327,205,544
LBK,12,2009,3952,1855,2097,495,53,103,250
HKK,12,2009,5902,2764,3138,1020,220,305,534
HKK,12,2009,3751,1746,2005,585,33,44,284
HKK,12,2009,4660,2115,2545,819,92,93,277
HKK,12,2009,3016,1511,1505,473,59,59,249
HKK,12,2009,6044,2827,3217,918,208,200,425
PAK,12,2009,5687,2585,3102,1026,72,89,481
PAK,12,2009,6533,3095,3438,1083,120,136,509
PAK,12,2009,6912,3156,3756,1136,100,140,493
PAK,12,2009,7685,3643,4042,1028,121,125,528
VYS,12,2009,5041,2503,2538,736,30,23,397
VYS,12,2009,6276,2712,3564,925,74,91,527
VYS,12,2009,3024,1414,1610,538,32,39,256
VYS,12,2009,7695,3618,4077,1126,57,49,648
VYS,12,2009,6530,3020,3510,974,100,111,523
JHM,12,2009,6025,2906,3119,644,58,49,485
JHM,12,2009,18023,8853,9170,1668,819,907,870
JHM,12,2009,8577,4107,4470,1182,151,107,704
JHM,12,2009,7255,3311,3944,1296,74,111,634
JHM,12,2009,12681,5732,6949,1969,96,430,960
JHM,12,2009,4427,2030,2397,593,46,24,420
JHM,12,2009,8956,4321,4635,1581,45,108,657
OLK,12,2009,3409,1474,1935,799,22,21,200
OLK,12,2009,13876,6075,7801,1986,211,348,1009
OLK,12,2009,5889,3036,2853,869,27,85,393
OLK,12,2009,8710,4056,4654,1127,59,95,592
OLK,12,2009,9208,4205,5003,1150,31,88,574
ZLK,12,2009,6879,3085,3794,885,64,53,561
ZLK,12,2009,7583,3679,3904,992,68,75,365
ZLK,12,2009,9610,4305,5305,1195,172,187,702
ZLK,12,2009,9764,4723,5041,1192,76,118,709
MSK,12,2009,8273,3994,4279,1049,80,45,536
MSK,12,2009,10780,5030,5750,1393,240,129,794
MSK,12,2009,20824,10275,10549,1807,188,168,1092
MSK,12,2009,10278,4523,5755,1331,121,160,411
MSK,12,2009,10026,4508,5518,1454,103,91,781
MSK,12,2009,20400,9416,10984,1897,406,447,1085
PHA,1,2010,31137,14907,16230,5664,2924,2443,1500
STC,1,2010,3032,1410,1622,633,83,77,256
STC,1,2010,3340,1553,1787,579,81,89,169
STC,1,2010,7872,3761,4111,1143,168,132,579
STC,1,2010,5090,2466,2624,859,211,211,162
STC,1,2010,4060,1947,2113,608,258,133,188
STC,1,2010,4883,2510,2373,766,76,98,328
STC,1,2010,4163,2089,2074,754,112,89,192
STC,1,2010,4861,2310,2551,702,139,79,330
STC,1,2010,3077,1469,1608,691,201,142,161
STC,1,2010,2664,1285,1379,538,48,99,179
STC,1,2010,6666,2800,3866,1202,144,163,446
STC,1,2010,2720,1300,1420,419,27,70,227
JHC,1,2010,6550,3199,3351,1272,444,487,548
JHC,1,2010,4059,1837,2222,785,60,69,234
JHC,1,2010,4700,2241,2459,1044,76,64,351
JHC,1,2010,3355,1557,1798,722,95,153,196
JHC,1,2010,2238,969,1269,481,71,98,159
JHC,1,2010,3739,1694,2045,658,100,51,162
JHC,1,2010,5394,2531,2863,969,161,88,382
PLK,1,2010,3389,1631,1758,554,46,37,174
PLK,1,2010,4698,2169,2529,880,112,133,294
PLK,1,2010,7582,3789,3793,1224,480,705,295
PLK,1,2010,2472,1222,1250,440,16,48,202
PLK,1,2010,3534,1759,1775,765,53,43,207
PLK,1,2010,2284,1138,1146,374,30,22,111
PLK,1,2010,4621,2181,2440,659,41,64,249
KVK,1,2010,5919,2598,3321,955,146,111,251
KVK,1,2010,7802,3568,4234,1066,170,157,472
KVK,1,2010,6758,3198,3560,878,40,119,472
ULK,1,2010,11215,5382,5833,1409,89,92,662
ULK,1,2010,9664,4727,4937,1330,155,182,552
ULK,1,2010,7479,3608,3871,1054,108,113,400
ULK,1,2010,6517,3021,3496,880,55,45,389
ULK,1,2010,10224,5295,4929,1200,149,147,554
ULK,1,2010,9090,4513,4577,1164,129,120,649
ULK,1,2010,8620,3912,4708,1053,118,144,516
LBK,1,2010,7530,3798,3732,971,123,135,445
LBK,1,2010,5512,2666,2846,718,83,83,315
LBK,1,2010,10058,4833,5225,1480,283,418,539
LBK,1,2010,4119,1847,2272,655,91,110,230
HKK,1,2010,6473,2852,3621,1328,597,301,523
HKK,1,2010,4050,1802,2248,667,69,66,281
HKK,1,2010,5068,2201,2867,1033,145,201,271
HKK,1,2010,3289,1570,1719,671,53,51,245
HKK,1,2010,6336,2845,3491,1021,203,312,392
PAK,1,2010,6315,2710,3605,1121,97,134,468
PAK,1,2010,7018,3196,3822,1263,215,230,498
PAK,1,2010,7514,3229,4285,1113,121,165,478
PAK,1,2010,8361,3781,4580,1341,202,222,529
VYS,1,2010,5386,2513,2873,809,63,68,384
VYS,1,2010,6705,2722,3983,1091,180,109,492
VYS,1,2010,3347,1460,1887,637,56,36,259
VYS,1,2010,8364,3725,4639,1183,107,140,672
VYS,1,2010,7074,3098,3976,1087,106,92,528
JHM,1,2010,6392,2987,3405,896,95,69,487
JHM,1,2010,18895,9054,9841,2666,1187,872,831
JHM,1,2010,9168,4214,4954,1421,159,388,692
JHM,1,2010,7942,3442,4500,1304,208,129,640
JHM,1,2010,13756,5844,7912,1948,175,88,979
JHM,1,2010,4835,2118,2717,779,80,75,417
JHM,1,2010,10056,4542,5514,1707,115,117,667
OLK,1,2010,3893,1564,2329,714,23,21,219
OLK,1,2010,14743,6258,8485,2328,512,403,983
OLK,1,2010,6436,3163,3273,1028,96,64,385
OLK,1,2010,9451,4175,5276,1406,109,76,582
OLK,1,2010,9643,4240,5403,1189,75,77,564
ZLK,1,2010,7303,3163,4140,961,174,164,554
ZLK,1,2010,8177,3795,4382,1207,156,177,346
ZLK,1,2010,10154,4406,5748,1243,268,246,698
ZLK,1,2010,10477,4888,5589,1582,198,195,711
MSK,1,2010,8823,4044,4779,1209,117,110,542
MSK,1,2010,11509,5163,6346,1833,310,460,771
MSK,1,2010,21584,10514,11070,2317,319,382,1112
MSK,1,2010,10752,4559,6193,1437,191,213,432
MSK,1,2010,10787,4642,6145,1687,165,165,747
MSK,1,2010,21463,9698,11765,2651,888,719,1127
PHA,2,2010,31961,15173,16788,4907,3941,3984,1488
STC,2,2010,3081,1412,1669,458,102,119,248
STC,2,2010,3479,1622,1857,443,72,74,178
STC,2,2010,8006,3817,4189,900,133,161,564
STC,2,2010,5276,2530,2746,609,201,162,167
STC,2,2010,4201,1979,2222,464,200,133,186
STC,2,2010,5009,2551,2458,567,58,83,330
STC,2,2010,4206,2077,2129,508,109,109,194
STC,2,2010,4948,2318,2630,491,441,613,346
STC,2,2010,3154,1472,1682,524,291,163,168
STC,2,2010,2711,1289,1422,425,91,82,173
STC,2,2010,6840,2836,4004,754,203,107,464
STC,2,2010,2838,1330,1508,330,147,60,223
JHC,2,2010,6730,3189,3541,937,366,315,562
JHC,2,2010,4137,1835,2302,470,60,42,233
JHC,2,2010,4815,2249,2566,546,69,74,359
JHC,2,2010,3439,1571,1868,390,109,102,216
JHC,2,2010,2372,1003,1369,376,74,53,164
JHC,2,2010,3804,1691,2113,392,57,91,161
JHC,2,2010,5587,2578,3009,621,122,122,400
PLK,2,2010,3425,1627,1798,334,53,47,167
PLK,2,2010,4831,2197,2634,509,101,99,291
PLK,2,2010,7715,3821,3894,953,445,571,293
PLK,2,2010,2481,1228,1253,278,36,36,205
PLK,2,2010,3566,1786,1780,410,102,74,200
PLK,2,2010,2244,1119,1125,218,39,56,106
PLK,2,2010,4607,2146,2461,363,30,28,251
KVK,2,2010,5929,2594,3335,673,144,108,242
KVK,2,2010,7927,3623,4304,723,228,189,472
KVK,2,2010,6841,3193,3648,622,128,77,468
ULK,2,2010,11287,5323,5964,853,152,71,653
ULK,2,2010,9811,4799,5012,926,118,110,564
ULK,2,2010,7607,3634,3973,680,237,133,391
ULK,2,2010,6717,3113,3604,637,37,44,387
ULK,2,2010,10365,5331,5034,822,178,136,541
ULK,2,2010,9233,4560,4673,811,169,164,635
ULK,2,2010,8772,3990,4782,774,143,117,541
LBK,2,2010,7520,3772,3748,680,226,205,448
LBK,2,2010,5547,2673,2874,541,79,108,324
LBK,2,2010,10012,4826,5186,1010,271,330,524
LBK,2,2010,4199,1866,2333,431,93,54,238
HKK,2,2010,6615,2872,3743,791,347,358,498
HKK,2,2010,4150,1841,2309,434,82,68,282
HKK,2,2010,5163,2235,2928,644,186,129,272
HKK,2,2010,3360,1606,1754,394,59,60,240
HKK,2,2010,6384,2849,3535,617,166,182,400
PAK,2,2010,6444,2703,3741,632,136,128,447
PAK,2,2010,7167,3219,3948,879,307,566,498
PAK,2,2010,7616,3194,4422,678,161,147,478
PAK,2,2010,8370,3758,4612,715,179,180,523
VYS,2,2010,5431,2503,2928,490,92,53,382
VYS,2,2010,6743,2722,4021,608,172,145,508
VYS,2,2010,3379,1504,1875,359,55,61,251
VYS,2,2010,8414,3692,4722,624,104,92,666
VYS,2,2010,7227,3115,4112,610,90,96,528
JHM,2,2010,6439,2976,3463,565,74,97,514
JHM,2,2010,19215,9213,10002,1947,880,1116,861
JHM,2,2010,9279,4230,5049,959,197,256,706
JHM,2,2010,8076,3423,4653,763,343,249,654
JHM,2,2010,13833,5845,7988,971,297,302,966
JHM,2,2010,4830,2091,2739,454,107,111,407
JHM,2,2010,10212,4560,5652,824,151,85,674
OLK,2,2010,4005,1595,2410,366,53,36,218
OLK,2,2010,14966,6314,8652,1358,525,469,995
OLK,2,2010,6519,3173,3346,580,128,95,390
OLK,2,2010,9604,4221,5383,769,89,68,601
OLK,2,2010,9769,4254,5515,717,101,72,555
ZLK,2,2010,7353,3157,4196,559,105,110,561
ZLK,2,2010,8241,3773,4468,704,88,163,329
ZLK,2,2010,10217,4341,5876,785,289,179,713
ZLK,2,2010,10732,4951,5781,1100,203,135,719
MSK,2,2010,9044,4040,5004,748,110,118,574
MSK,2,2010,11649,5219,6430,1129,521,450,788
MSK,2,2010,21832,10552,11280,1733,221,220,1123
MSK,2,2010,10785,4557,6228,954,199,186,434
MSK,2,2010,11082,4692,6390,1045,143,172,778
MSK,2,2010,21760,9778,11982,2079,544,436,1186
PHA,3,2010,32562,15486,17076,5108,4123,4763,1505
STC,3,2010,3044,1397,1647,445,200,159,247
STC,3,2010,3445,1602,1843,418,95,85,172
STC,3,2010,8003,3816,4187,866,141,131,574
STC,3,2010,5129,2451,2678,571,189,166,160
STC,3,2010,4155,1995,2160,417,120,246,188
STC,3,2010,4995,2541,2454,594,209,87,326
STC,3,2010,4283,2097,2186,597,95,139,204
STC,3,2010,4890,2291,2599,492,169,126,335
STC,3,2010,3130,1455,1675,529,193,390,148
STC,3,2010,2753,1312,1441,461,176,94,173
STC,3,2010,6632,2787,3845,640,152,216,452
STC,3,2010,2860,1349,1511,357,54,158,231
JHC,3,2010,6597,3192,3405,921,417,381,571
JHC,3,2010,3943,1811,2132,373,69,78,235
JHC,3,2010,4578,2212,2366,432,108,78,349
JHC,3,2010,3140,1479,1661,380,99,83,203
JHC,3,2010,2270,974,1296,291,122,97,154
JHC,3,2010,3709,1675,2034,373,110,103,161
JHC,3,2010,5458,2538,2920,536,160,171,424
PLK,3,2010,3340,1666,1674,327,80,83,175
PLK,3,2010,4761,2183,2578,576,146,176,282
PLK,3,2010,7765,3812,3953,1027,605,550,300
PLK,3,2010,2431,1195,1236,291,32,23,209
PLK,3,2010,3465,1751,1714,451,97,70,176
PLK,3,2010,2152,1104,1048,211,36,40,114
PLK,3,2010,4463,2101,2362,337,48,31,242
KVK,3,2010,5782,2540,3242,595,142,174,230
KVK,3,2010,7845,3562,4283,722,238,210,472
KVK,3,2010,6731,3113,3618,642,88,95,450
ULK,3,2010,11166,5284,5882,884,142,224,648
ULK,3,2010,9775,4784,4991,995,163,149,540
ULK,3,2010,7247,3541,3706,682,245,246,364
ULK,3,2010,6622,3115,3507,651,89,62,382
ULK,3,2010,10202,5191,5011,842,207,239,524
ULK,3,2010,9167,4546,4621,809,166,177,604
ULK,3,2010,8873,4050,4823,871,149,192,559
LBK,3,2010,7455,3715,3740,716,280,254,467
LBK,3,2010,5582,2684,2898,598,139,112,346
LBK,3,2010,10065,4814,5251,1124,364,286,520
LBK,3,2010,4083,1830,2253,355,90,123,238
HKK,3,2010,6418,2882,3536,815,595,616,502
HKK,3,2010,4099,1848,2251,388,150,114,286
HKK,3,2010,5067,2191,2876,561,183,133,247
HKK,3,2010,3236,1574,1662,355,91,72,229
HKK,3,2010,6272,2849,3423,661,202,155,399
PAK,3,2010,6182,2672,3510,542,182,182,429
PAK,3,2010,7046,3200,3846,840,479,252,475
PAK,3,2010,7390,3136,4254,559,219,199,477
PAK,3,2010,8175,3699,4476,708,239,201,515
VYS,3,2010,5160,2452,2708,455,88,94,388
VYS,3,2010,6530,2705,3825,585,160,193,525
VYS,3,2010,3242,1469,1773,331,63,57,237
VYS,3,2010,8049,3594,4455,588,146,144,652
VYS,3,2010,7115,3143,3972,629,113,141,544
JHM,3,2010,6290,2922,3368,546,133,90,508
JHM,3,2010,19303,9262,10041,1905,941,1173,824
JHM,3,2010,9288,4265,5023,1097,191,196,706
JHM,3,2010,7748,3316,4432,644,429,400,624
JHM,3,2010,13330,5640,7690,917,344,222,951
JHM,3,2010,4651,2018,2633,438,114,84,377
JHM,3,2010,9629,4365,5264,704,254,134,644
OLK,3,2010,3907,1575,2332,333,20,37,207
OLK,3,2010,14271,6198,8073,1219,1001,620,990
OLK,3,2010,6255,3081,3174,530,165,152,350
OLK,3,2010,9332,4214,5118,750,213,140,584
OLK,3,2010,9498,4198,5300,657,398,162,526
ZLK,3,2010,7145,3069,4076,536,180,134,541
ZLK,3,2010,7986,3716,4270,722,112,145,302
ZLK,3,2010,9970,4264,5706,714,284,288,666
ZLK,3,2010,10580,4902,5678,974,259,206,709
MSK,3,2010,8854,3997,4857,642,195,158,574
MSK,3,2010,11497,5177,6320,1182,602,605,771
MSK,3,2010,21606,10465,11141,1713,283,277,1088
MSK,3,2010,10489,4492,5997,968,449,344,420
MSK,3,2010,10737,4594,6143,870,186,203,754
MSK,3,2010,21929,9927,12002,2140,1262,865,1217
PHA,4,2010,32755,15682,17073,4880,2367,4088,1463
STC,4,2010,2758,1312,1446,359,73,76,224
STC,4,2010,3382,1588,1794,400,129,74,165
STC,4,2010,7896,3859,4037,854,129,113,566
STC,4,2010,4790,2398,2392,456,182,184,149
STC,4,2010,3726,1865,1861,380,140,91,174
STC,4,2010,4901,2532,2369,601,104,109,306
STC,4,2010,4170,2078,2092,493,135,115,190
STC,4,2010,4464,2161,2303,415,229,217,282
STC,4,2010,3117,1489,1628,510,151,113,129
STC,4,2010,2711,1329,1382,408,128,112,150
STC,4,2010,6135,2719,3416,617,112,107,420
STC,4,2010,2656,1309,1347,286,34,51,220
JHC,4,2010,6247,3104,3143,890,447,430,536
JHC,4,2010,3533,1712,1821,386,124,67,223
JHC,4,2010,3744,1943,1801,335,131,129,299
JHC,4,2010,2734,1345,1389,360,169,120,182
JHC,4,2010,2019,925,1094,289,75,83,162
JHC,4,2010,3413,1634,1779,350,80,74,161
JHC,4,2010,5233,2482,2751,636,168,93,399
PLK,4,2010,3109,1618,1491,272,116,88,168
PLK,4,2010,4249,2059,2190,474,150,88,250
PLK,4,2010,7588,3770,3818,942,420,465,278
PLK,4,2010,2248,1147,1101,261,76,27,185
PLK,4,2010,3259,1716,1543,405,52,62,177
PLK,4,2010,2035,1061,974,223,39,37,102
PLK,4,2010,4128,2027,2101,344,80,77,228
KVK,4,2010,5464,2434,3030,479,228,176,212
KVK,4,2010,7460,3402,4058,640,219,191,445
KVK,4,2010,6497,3056,3441,614,67,70,432
ULK,4,2010,10731,5139,5592,854,119,94,623
ULK,4,2010,9309,4614,4695,927,206,169,493
ULK,4,2010,6855,3422,3433,625,165,203,329
ULK,4,2010,6350,3040,3310,603,61,166,365
ULK,4,2010,9938,5068,4870,752,123,129,511
ULK,4,2010,8950,4479,4471,737,171,162,567
ULK,4,2010,8833,4037,4796,828,235,144,551
LBK,4,2010,7090,3617,3473,614,366,399,437
LBK,4,2010,5467,2664,2803,561,86,66,332
LBK,4,2010,9857,4751,5106,979,381,307,497
LBK,4,2010,3940,1857,2083,489,119,94,230
HKK,4,2010,6024,2833,3191,709,464,493,464
HKK,4,2010,3753,1844,1909,413,103,96,264
HKK,4,2010,4672,2145,2527,562,217,186,233
HKK,4,2010,2977,1567,1410,409,192,95,190
HKK,4,2010,5940,2770,3170,676,234,170,374
PAK,4,2010,5463,2541,2922,509,163,138,379
PAK,4,2010,6581,3093,3488,762,1080,534,438
PAK,4,2010,6498,2930,3568,507,236,141,439
PAK,4,2010,7665,3581,4084,673,274,221,471
VYS,4,2010,4751,2415,2336,454,84,82,378
VYS,4,2010,5702,2558,3144,490,150,155,488
VYS,4,2010,2822,1391,1431,290,73,61,214
VYS,4,2010,7289,3452,3837,595,100,88,622
VYS,4,2010,6466,3029,3437,495,102,98,505
JHM,4,2010,5957,2852,3105,506,88,114,478
JHM,4,2010,19189,9252,9937,1860,904,1056,801
JHM,4,2010,8834,4116,4718,835,168,192,691
JHM,4,2010,6803,3002,3801,543,209,298,556
JHM,4,2010,12344,5434,6910,1007,240,277,883
JHM,4,2010,4264,1938,2326,440,93,119,350
JHM,4,2010,8322,3932,4390,616,460,169,596
OLK,4,2010,3335,1462,1873,304,19,15,190
OLK,4,2010,13106,5979,7127,1103,709,729,923
OLK,4,2010,5901,3039,2862,634,118,156,329
OLK,4,2010,8663,4078,4585,650,120,139,539
OLK,4,2010,8582,3955,4627,590,227,355,470
ZLK,4,2010,6726,2990,3736,523,175,165,515
ZLK,4,2010,7473,3656,3817,708,116,84,287
ZLK,4,2010,9295,4050,5245,730,284,243,614
ZLK,4,2010,10001,4756,5245,890,234,191,682
MSK,4,2010,8176,3867,4309,687,178,153,549
MSK,4,2010,10574,4987,5587,1083,540,470,717
MSK,4,2010,21142,10349,10793,1698,244,232,1092
MSK,4,2010,9609,4284,5325,890,324,350,394
MSK,4,2010,9973,4534,5439,911,243,179,701
MSK,4,2010,21515,9883,11632,2026,813,884,1177
PHA,5,2010,32139,15542,16597,4030,2818,2787,1315
STC,5,2010,2614,1285,1329,388,76,80,181
STC,5,2010,3268,1576,1692,353,61,112,138
STC,5,2010,7742,3870,3872,781,153,107,493
STC,5,2010,4549,2375,2174,501,172,168,130
STC,5,2010,3489,1831,1658,412,115,171,142
STC,5,2010,4784,2517,2267,508,109,93,259
STC,5,2010,4051,2075,1976,474,150,176,171
STC,5,2010,4299,2122,2177,429,167,130,252
STC,5,2010,3069,1499,1570,485,254,158,127
STC,5,2010,2658,1319,1339,341,87,86,122
STC,5,2010,5822,2685,3137,584,132,116,367
STC,5,2010,2541,1275,1266,259,45,67,173
JHC,5,2010,5875,3016,2859,763,445,473,469
JHC,5,2010,3176,1540,1636,321,192,94,185
JHC,5,2010,3297,1836,1461,353,143,121,226
JHC,5,2010,2487,1288,1199,280,70,103,155
JHC,5,2010,1795,868,927,259,107,72,141
JHC,5,2010,3262,1630,1632,317,91,63,148
JHC,5,2010,5011,2464,2547,491,177,181,330
PLK,5,2010,2950,1577,1373,254,60,47,140
PLK,5,2010,3988,1980,2008,428,120,112,213
PLK,5,2010,7459,3750,3709,898,565,502,247
PLK,5,2010,2159,1112,1047,234,54,49,151
PLK,5,2010,3074,1659,1415,331,46,80,156
PLK,5,2010,1978,1053,925,195,25,42,89
PLK,5,2010,3910,1954,1956,293,112,26,199
KVK,5,2010,5100,2305,2795,449,152,205,195
KVK,5,2010,7247,3320,3927,646,285,267,406
KVK,5,2010,6299,2998,3301,523,137,98,411
ULK,5,2010,10290,4959,5331,899,109,91,526
ULK,5,2010,9027,4525,4502,821,191,156,424
ULK,5,2010,6374,3253,3121,551,159,149,289
ULK,5,2010,6175,2945,3230,558,90,70,311
ULK,5,2010,9738,4988,4750,832,172,114,468
ULK,5,2010,8794,4419,4375,666,131,133,507
ULK,5,2010,8752,4040,4712,727,169,261,508
LBK,5,2010,6801,3504,3297,536,387,169,384
LBK,5,2010,5246,2610,2636,444,83,50,305
LBK,5,2010,9471,4636,4835,913,310,283,457
LBK,5,2010,3707,1809,1898,342,78,82,213
HKK,5,2010,5660,2747,2913,621,459,520,396
HKK,5,2010,3488,1801,1687,328,97,100,230
HKK,5,2010,4369,2119,2250,547,197,243,217
HKK,5,2010,2716,1482,1234,302,136,147,152
HKK,5,2010,5503,2655,2848,585,231,186,322
PAK,5,2010,4851,2387,2464,436,147,133,306
PAK,5,2010,6150,3024,3126,712,496,531,365
PAK,5,2010,6040,2876,3164,497,142,102,362
PAK,5,2010,7142,3442,3700,619,442,263,404
VYS,5,2010,4428,2336,2092,403,100,57,299
VYS,5,2010,5278,2475,2803,456,163,153,396
VYS,5,2010,2588,1349,1239,287,60,58,183
VYS,5,2010,6720,3306,3414,491,90,106,514
VYS,5,2010,5965,2950,3015,454,147,146,422
JHM,5,2010,5609,2750,2859,417,122,100,394
JHM,5,2010,19038,9267,9771,1589,832,956,728
JHM,5,2010,8505,4037,4468,787,184,177,607
JHM,5,2010,6225,2886,3339,595,238,245,466
JHM,5,2010,11692,5309,6383,742,153,202,720
JHM,5,2010,3977,1869,2108,373,80,111,292
JHM,5,2010,7294,3559,3735,583,275,416,510
OLK,5,2010,3169,1595,1574,513,29,21,147
OLK,5,2010,12422,5894,6528,1045,590,799,771
OLK,5,2010,5805,3145,2660,684,171,153,286
OLK,5,2010,8358,4039,4319,653,229,188,446
OLK,5,2010,7908,3824,4084,535,182,216,395
ZLK,5,2010,6412,2915,3497,496,170,266,427
ZLK,5,2010,7112,3596,3516,604,116,143,224
ZLK,5,2010,8644,3903,4741,642,257,229,522
ZLK,5,2010,9491,4632,4859,802,256,259,586
MSK,5,2010,7634,3742,3892,559,178,201,459
MSK,5,2010,9959,4875,5084,994,412,414,586
MSK,5,2010,20677,10251,10426,1472,268,277,921
MSK,5,2010,9104,4165,4939,804,263,259,345
MSK,5,2010,9414,4479,4935,834,201,218,616
MSK,5,2010,20965,9816,11149,1731,742,723,1038
PHA,6,2010,31794,15584,16210,4389,2823,3187,1253
STC,6,2010,2487,1246,1241,340,102,80,161
STC,6,2010,3249,1591,1658,358,106,73,114
STC,6,2010,7671,3863,3808,788,117,145,446
STC,6,2010,4554,2403,2151,541,178,167,115
STC,6,2010,3373,1784,1589,352,195,170,126
STC,6,2010,4777,2520,2257,569,129,71,220
STC,6,2010,3964,2095,1869,441,100,120,148
STC,6,2010,4375,2205,2170,519,401,372,242
STC,6,2010,3032,1486,1546,486,194,214,133
STC,6,2010,2626,1314,1312,371,75,82,108
STC,6,2010,5706,2668,3038,585,168,134,309
STC,6,2010,2464,1274,1190,250,61,39,153
JHC,6,2010,5722,3001,2721,812,607,561,405
JHC,6,2010,2980,1460,1520,326,86,167,156
JHC,6,2010,3072,1788,1284,367,89,105,168
JHC,6,2010,2347,1268,1079,295,95,98,132
JHC,6,2010,1714,867,847,262,75,86,125
JHC,6,2010,3175,1625,1550,302,86,88,116
JHC,6,2010,4711,2440,2271,470,177,170,295
PLK,6,2010,2847,1531,1316,292,74,74,111
PLK,6,2010,3872,1976,1896,437,130,137,199
PLK,6,2010,7346,3746,3600,924,549,354,230
PLK,6,2010,2104,1089,1015,262,221,195,130
PLK,6,2010,2920,1607,1313,345,64,64,125
PLK,6,2010,1934,1064,870,209,42,42,73
PLK,6,2010,3779,1913,1866,306,130,163,175
KVK,6,2010,4974,2277,2697,480,117,79,197
KVK,6,2010,7018,3267,3751,612,263,279,323
KVK,6,2010,6100,2956,3144,536,105,62,361
ULK,6,2010,10020,4873,5147,740,87,117,469
ULK,6,2010,8863,4516,4347,803,186,207,380
ULK,6,2010,6192,3223,2969,545,105,134,242
ULK,6,2010,5971,2881,3090,524,72,57,268
ULK,6,2010,9584,4940,4644,714,177,130,415
ULK,6,2010,8600,4326,4274,637,119,111,433
ULK,6,2010,8637,4032,4605,697,120,221,447
LBK,6,2010,6507,3384,3123,541,190,199,331
LBK,6,2010,5045,2557,2488,416,101,147,269
LBK,6,2010,9437,4671,4766,1058,347,256,419
LBK,6,2010,3549,1807,1742,330,98,92,164
HKK,6,2010,5512,2710,2802,694,390,367,342
HKK,6,2010,3357,1766,1591,319,84,101,188
HKK,6,2010,4208,2124,2084,521,151,136,183
HKK,6,2010,2596,1466,1130,346,74,82,121
HKK,6,2010,5264,2601,2663,541,235,172,266
PAK,6,2010,4648,2332,2316,526,121,119,253
PAK,6,2010,5792,2966,2826,679,558,671,293
PAK,6,2010,5783,2840,2943,481,222,204,293
PAK,6,2010,6829,3402,3427,618,524,478,337
VYS,6,2010,4229,2275,1954,366,70,71,238
VYS,6,2010,5056,2442,2614,515,152,108,324
VYS,6,2010,2460,1326,1134,314,79,44,139
VYS,6,2010,6630,3379,3251,564,84,82,402
VYS,6,2010,5758,2944,2814,481,115,114,352
JHM,6,2010,5411,2700,2711,436,122,84,296
JHM,6,2010,18795,9290,9505,1674,818,904,677
JHM,6,2010,8301,4055,4246,814,155,140,497
JHM,6,2010,5970,2840,3130,563,171,291,389
JHM,6,2010,11428,5281,6147,867,196,208,593
JHM,6,2010,3819,1845,1974,423,154,146,224
JHM,6,2010,6762,3407,3355,584,398,184,377
OLK,6,2010,2948,1523,1425,233,36,27,115
OLK,6,2010,11991,5839,6152,1087,551,567,636
OLK,6,2010,5681,3140,2541,519,175,126,228
OLK,6,2010,8056,3998,4058,564,156,152,376
OLK,6,2010,7613,3743,3870,628,165,165,322
ZLK,6,2010,6235,2878,3357,550,148,151,356
ZLK,6,2010,6896,3551,3345,625,141,161,203
ZLK,6,2010,8380,3874,4506,671,506,583,411
ZLK,6,2010,9221,4621,4600,811,231,267,484
MSK,6,2010,7335,3688,3647,529,150,172,374
MSK,6,2010,9590,4820,4770,980,454,528,499
MSK,6,2010,20258,10110,10148,1488,252,224,807
MSK,6,2010,8828,4105,4723,859,291,242,273
MSK,6,2010,9157,4478,4679,902,226,126,525
MSK,6,2010,20611,9788,10823,1785,646,894,926
PHA,7,2010,32856,16510,16346,4824,2182,2477,1278
STC,7,2010,2556,1306,1250,431,50,93,168
STC,7,2010,3260,1679,1581,377,69,53,119
STC,7,2010,7806,3988,3818,859,157,126,451
STC,7,2010,4633,2501,2132,534,170,178,110
STC,7,2010,3423,1858,1565,423,126,184,119
STC,7,2010,4829,2594,2235,529,179,137,229
STC,7,2010,4087,2210,1877,498,116,69,131
STC,7,2010,4470,2310,2160,464,146,155,246
STC,7,2010,3131,1578,1553,559,215,215,132
STC,7,2010,2690,1389,1301,440,48,171,102
STC,7,2010,5763,2771,2992,616,135,119,309
STC,7,2010,2461,1305,1156,272,32,29,151
JHC,7,2010,5840,3138,2702,892,532,461,437
JHC,7,2010,2921,1469,1452,303,58,73,165
JHC,7,2010,3006,1796,1210,421,116,53,190
JHC,7,2010,2408,1357,1051,392,148,93,161
JHC,7,2010,1695,871,824,251,63,56,115
JHC,7,2010,3217,1662,1555,357,91,46,124
JHC,7,2010,4759,2525,2234,571,138,162,292
PLK,7,2010,2860,1548,1312,262,78,54,112
PLK,7,2010,3949,2074,1875,503,122,105,240
PLK,7,2010,7515,3930,3585,1060,271,499,273
PLK,7,2010,2098,1111,987,252,41,48,122
PLK,7,2010,2997,1666,1331,419,47,60,134
PLK,7,2010,1962,1118,844,246,87,65,85
PLK,7,2010,3705,1910,1795,336,60,47,170
KVK,7,2010,4932,2345,2587,503,196,192,198
KVK,7,2010,6997,3338,3659,628,175,187,312
KVK,7,2010,6161,3049,3112,600,122,142,365
ULK,7,2010,10035,4990,5045,840,89,66,429
ULK,7,2010,8845,4542,4303,818,161,100,365
ULK,7,2010,6205,3289,2916,675,216,125,247
ULK,7,2010,5897,2905,2992,572,35,56,258
ULK,7,2010,9660,5063,4597,812,121,129,429
ULK,7,2010,8604,4392,4212,648,115,67,410
ULK,7,2010,8698,4109,4589,771,127,95,451
LBK,7,2010,6545,3455,3090,628,114,175,309
LBK,7,2010,5064,2601,2463,491,86,93,284
LBK,7,2010,9617,4841,4776,1100,350,254,434
LBK,7,2010,3563,1858,1705,344,55,50,156
HKK,7,2010,5653,2868,2785,798,351,433,386
HKK,7,2010,3409,1849,1560,407,101,72,180
HKK,7,2010,4258,2250,2008,629,194,168,199
HKK,7,2010,2636,1503,1133,411,106,92,128
HKK,7,2010,5198,2663,2535,565,169,188,251
PAK,7,2010,4684,2475,2209,621,107,85,257
PAK,7,2010,5904,3129,2775,860,571,376,323
PAK,7,2010,5841,2952,2889,583,123,155,309
PAK,7,2010,6889,3528,3361,755,302,502,387
VYS,7,2010,4272,2350,1922,454,65,54,246
VYS,7,2010,5117,2615,2502,640,178,111,333
VYS,7,2010,2441,1370,1071,338,101,48,157
VYS,7,2010,6763,3569,3194,739,75,59,416
VYS,7,2010,5901,3125,2776,694,111,87,393
JHM,7,2010,5367,2755,2612,505,101,121,315
JHM,7,2010,19342,9827,9515,2133,1047,704,702
JHM,7,2010,8451,4274,4177,990,167,119,538
JHM,7,2010,6045,2945,3100,704,192,186,412
JHM,7,2010,11419,5444,5975,966,167,128,641
JHM,7,2010,3782,1926,1856,460,142,86,223
JHM,7,2010,6640,3454,3186,732,197,339,370
OLK,7,2010,2901,1528,1373,324,9,37,127
OLK,7,2010,12157,6110,6047,1314,471,459,672
OLK,7,2010,5688,3197,2491,601,155,144,238
OLK,7,2010,8168,4163,4005,759,178,127,395
OLK,7,2010,7580,3828,3752,700,130,141,329
ZLK,7,2010,6285,2981,3304,612,98,111,354
ZLK,7,2010,6907,3681,3226,731,148,141,205
ZLK,7,2010,8442,4007,4435,808,329,278,436
ZLK,7,2010,9219,4788,4431,936,258,244,505
MSK,7,2010,7357,3823,3534,655,155,105,379
MSK,7,2010,9518,4918,4600,1136,349,311,556
MSK,7,2010,20282,10269,10013,1611,247,232,870
MSK,7,2010,8956,4331,4625,992,236,237,297
MSK,7,2010,9220,4663,4557,917,162,174,557
MSK,7,2010,20872,10110,10762,2033,559,525,963
PHA,8,2010,33059,16685,16374,4433,3200,1854,1428
STC,8,2010,2588,1336,1252,421,90,73,191
STC,8,2010,3311,1713,1598,402,131,72,137
STC,8,2010,7845,4011,3834,882,107,115,546
STC,8,2010,4603,2507,2096,504,232,214,110
STC,8,2010,3423,1877,1546,386,247,114,130
STC,8,2010,4805,2587,2218,481,77,162,293
STC,8,2010,3932,2175,1757,455,916,771,136
STC,8,2010,4519,2341,2178,463,195,215,265
STC,8,2010,3111,1587,1524,447,224,227,156
STC,8,2010,2663,1399,1264,343,118,75,88
STC,8,2010,5759,2768,2991,583,133,149,367
STC,8,2010,2367,1263,1104,228,52,77,163
JHC,8,2010,5802,3166,2636,867,278,306,490
JHC,8,2010,2936,1481,1455,364,56,95,176
JHC,8,2010,2938,1807,1131,345,110,162,217
JHC,8,2010,2455,1421,1034,387,165,91,220
JHC,8,2010,1657,854,803,240,54,88,123
JHC,8,2010,3156,1657,1499,301,94,74,131
JHC,8,2010,4730,2557,2173,509,213,180,316
PLK,8,2010,2868,1539,1329,309,63,66,164
PLK,8,2010,3864,2022,1842,397,203,155,272
PLK,8,2010,7467,3955,3512,856,523,496,260
PLK,8,2010,2069,1124,945,249,44,25,158
PLK,8,2010,2989,1685,1304,418,43,35,185
PLK,8,2010,1932,1128,804,210,61,76,102
PLK,8,2010,3500,1806,1694,243,89,27,163
KVK,8,2010,4767,2270,2497,447,118,165,209
KVK,8,2010,6940,3349,3591,620,238,261,323
KVK,8,2010,6043,2979,3064,552,206,134,371
ULK,8,2010,9968,4980,4988,776,198,216,460
ULK,8,2010,8742,4529,4213,867,291,286,400
ULK,8,2010,6112,3281,2831,576,117,132,268
ULK,8,2010,5810,2884,2926,535,62,54,306
ULK,8,2010,9609,5035,4574,722,130,148,497
ULK,8,2010,8607,4441,4166,723,99,94,466
ULK,8,2010,8739,4152,4587,738,139,107,488
LBK,8,2010,6419,3452,2967,605,202,175,321
LBK,8,2010,4925,2526,2399,411,77,92,297
LBK,8,2010,9478,4832,4646,1004,535,471,439
LBK,8,2010,3550,1881,1669,369,87,75,187
HKK,8,2010,5702,2930,2772,719,489,407,476
HKK,8,2010,3318,1819,1499,327,115,91,208
HKK,8,2010,4136,2204,1932,487,177,155,236
HKK,8,2010,2618,1497,1121,358,61,106,151
HKK,8,2010,5141,2666,2475,517,210,300,292
PAK,8,2010,4720,2522,2198,534,157,103,320
PAK,8,2010,5809,3119,2690,726,499,582,387
PAK,8,2010,5722,2905,2817,475,323,147,332
PAK,8,2010,6714,3503,3211,630,213,229,439
VYS,8,2010,4253,2376,1877,398,86,98,290
VYS,8,2010,5121,2690,2431,561,246,256,411
VYS,8,2010,2377,1343,1034,283,46,128,178
VYS,8,2010,6682,3570,3112,515,70,43,472
VYS,8,2010,5893,3150,2743,582,174,106,487
JHM,8,2010,5284,2766,2518,475,179,127,366
JHM,8,2010,19348,9921,9427,1812,1369,897,755
JHM,8,2010,8422,4285,4137,873,211,129,651
JHM,8,2010,5952,2948,3004,613,217,243,490
JHM,8,2010,11389,5434,5955,989,276,197,809
JHM,8,2010,3778,1960,1818,461,111,69,265
JHM,8,2010,6547,3476,3071,712,409,429,452
OLK,8,2010,2852,1547,1305,265,57,37,150
OLK,8,2010,11995,6118,5877,1144,451,465,776
OLK,8,2010,5658,3254,2404,658,154,169,300
OLK,8,2010,8136,4178,3958,656,100,121,455
OLK,8,2010,7484,3828,3656,639,187,137,381
ZLK,8,2010,6254,3014,3240,579,175,154,410
ZLK,8,2010,6794,3661,3133,626,189,148,230
ZLK,8,2010,8318,4005,4313,675,228,195,555
ZLK,8,2010,9032,4768,4264,827,338,309,613
MSK,8,2010,7353,3849,3504,615,177,198,430
MSK,8,2010,9523,4973,4550,1092,407,400,691
MSK,8,2010,20222,10368,9854,1559,303,244,990
MSK,8,2010,8804,4292,4512,900,375,265,387
MSK,8,2010,9131,4695,4436,838,204,158,646
MSK,8,2010,20955,10311,10644,1953,727,593,1083
PHA,9,2010,32876,16515,16361,5877,2677,3472,1864
STC,9,2010,2734,1403,1331,673,112,115,328
STC,9,2010,3329,1710,1619,580,61,125,166
STC,9,2010,7891,4037,3854,1172,159,146,694
STC,9,2010,4610,2482,2128,721,147,153,95
STC,9,2010,3426,1841,1585,582,237,160,179
STC,9,2010,4855,2596,2259,790,105,116,447
STC,9,2010,3967,2200,1767,700,193,237,175
STC,9,2010,4477,2311,2166,619,255,234,334
STC,9,2010,3118,1597,1521,690,152,205,333
STC,9,2010,2652,1376,1276,533,71,63,97
STC,9,2010,5777,2782,2995,863,136,169,524
STC,9,2010,2361,1262,1099,411,47,31,246
JHC,9,2010,5822,3153,2669,1259,394,411,661
JHC,9,2010,3031,1529,1502,559,155,170,260
JHC,9,2010,2991,1805,1186,621,67,63,342
JHC,9,2010,2396,1354,1042,517,269,241,268
JHC,9,2010,1590,784,806,312,125,85,159
JHC,9,2010,3169,1649,1520,517,95,122,194
JHC,9,2010,4647,2516,2131,657,161,163,396
PLK,9,2010,2823,1512,1311,435,68,94,225
PLK,9,2010,3852,2005,1847,618,158,191,361
PLK,9,2010,7265,3782,3483,1272,500,412,427
PLK,9,2010,2076,1102,974,391,42,33,217
PLK,9,2010,2932,1624,1308,522,37,21,283
PLK,9,2010,1893,1090,803,324,52,49,136
PLK,9,2010,3528,1816,1712,534,118,105,266
KVK,9,2010,4751,2272,2479,702,124,131,271
KVK,9,2010,6921,3305,3616,915,209,271,467
KVK,9,2010,6101,3011,3090,828,122,126,519
ULK,9,2010,9889,4931,4958,1214,88,79,627
ULK,9,2010,8676,4489,4187,1203,242,193,538
ULK,9,2010,6326,3343,2983,1056,175,154,480
ULK,9,2010,5731,2843,2888,784,82,95,444
ULK,9,2010,9657,5057,4600,1097,127,119,640
ULK,9,2010,8687,4503,4184,1020,128,133,657
ULK,9,2010,8768,4156,4612,1011,166,178,567
LBK,9,2010,6287,3403,2884,852,154,208,427
LBK,9,2010,4797,2457,2340,687,76,65,344
LBK,9,2010,9364,4744,4620,1440,354,345,533
LBK,9,2010,3560,1884,1676,521,159,98,245
HKK,9,2010,5746,2916,2830,1099,493,522,639
HKK,9,2010,3219,1757,1462,512,117,116,281
HKK,9,2010,4170,2212,1958,819,194,221,387
HKK,9,2010,2611,1466,1145,523,126,85,250
HKK,9,2010,5215,2631,2584,884,170,175,442
PAK,9,2010,4739,2496,2243,792,149,170,443
PAK,9,2010,5805,3045,2760,1205,418,675,511
PAK,9,2010,5652,2877,2775,760,236,241,503
PAK,9,2010,6633,3432,3201,1038,269,274,569
VYS,9,2010,4186,2301,1885,611,63,77,370
VYS,9,2010,5038,2597,2441,805,272,236,542
VYS,9,2010,2355,1325,1030,451,50,50,235
VYS,9,2010,6738,3601,3137,877,123,113,656
VYS,9,2010,5729,2982,2747,750,127,212,612
JHM,9,2010,5284,2741,2543,772,161,179,513
JHM,9,2010,19157,9746,9411,2349,1256,1127,908
JHM,9,2010,8358,4290,4068,1330,199,167,908
JHM,9,2010,6091,3019,3072,1027,135,155,665
JHM,9,2010,11413,5433,5980,1385,233,267,1034
JHM,9,2010,3859,2003,1856,724,103,161,396
JHM,9,2010,6450,3381,3069,1083,341,415,640
OLK,9,2010,2837,1536,1301,387,13,26,223
OLK,9,2010,11939,6083,5856,1823,503,588,1081
OLK,9,2010,5719,3319,2400,934,118,142,486
OLK,9,2010,8131,4108,4023,975,157,177,613
OLK,9,2010,7478,3800,3678,996,165,163,499
ZLK,9,2010,6231,3036,3195,846,132,188,578
ZLK,9,2010,6764,3567,3197,994,163,212,394
ZLK,9,2010,8215,3945,4270,1038,227,281,752
ZLK,9,2010,8970,4708,4262,1277,294,236,891
MSK,9,2010,7509,3984,3525,986,115,108,581
MSK,9,2010,9461,4898,4563,1481,543,489,930
MSK,9,2010,20418,10444,9974,2292,198,204,1446
MSK,9,2010,8566,4172,4394,1169,257,307,588
MSK,9,2010,9294,4728,4566,1379,160,223,909
MSK,9,2010,20898,10253,10645,2626,742,725,1401
PHA,10,2010,32386,16205,16181,4731,2590,3447,1918
STC,10,2010,2720,1380,1340,468,84,82,325
STC,10,2010,3309,1678,1631,396,50,79,177
STC,10,2010,7872,4015,3857,826,109,206,695
STC,10,2010,4599,2433,2166,573,147,166,98
STC,10,2010,3370,1792,1578,383,188,288,174
STC,10,2010,4856,2602,2254,571,71,113,436
STC,10,2010,3829,2156,1673,482,159,163,189
STC,10,2010,4439,2272,2167,472,167,230,336
STC,10,2010,3095,1592,1503,537,276,222,317
STC,10,2010,2610,1344,1266,416,69,125,171
STC,10,2010,5751,2758,2993,603,110,114,507
STC,10,2010,2322,1234,1088,274,36,36,250
JHC,10,2010,5745,3075,2670,839,404,422,637
JHC,10,2010,3191,1608,1583,590,102,80,241
JHC,10,2010,3061,1858,1203,520,53,81,348
JHC,10,2010,2298,1280,1018,338,134,242,227
JHC,10,2010,1613,782,831,292,113,80,168
JHC,10,2010,3156,1638,1518,333,114,129,205
JHC,10,2010,4630,2502,2128,531,128,160,387
PLK,10,2010,2694,1447,1247,281,58,49,198
PLK,10,2010,3870,2008,1862,536,124,158,335
PLK,10,2010,7004,3627,3377,868,425,464,405
PLK,10,2010,2009,1072,937,256,102,135,198
PLK,10,2010,2876,1583,1293,404,39,20,243
PLK,10,2010,1818,1029,789,208,36,44,143
PLK,10,2010,3447,1780,1667,336,64,51,243
KVK,10,2010,4800,2249,2551,579,127,146,275
KVK,10,2010,6854,3269,3585,648,152,195,477
KVK,10,2010,6071,2981,3090,588,71,128,490
ULK,10,2010,9695,4860,4835,769,103,100,597
ULK,10,2010,8537,4397,4140,807,170,172,528
ULK,10,2010,6203,3270,2933,645,480,199,457
ULK,10,2010,5687,2828,2859,577,56,83,414
ULK,10,2010,9514,4961,4553,732,90,151,601
ULK,10,2010,8672,4473,4199,778,102,122,644
ULK,10,2010,8707,4097,4610,697,147,112,552
LBK,10,2010,6265,3421,2844,708,158,125,446
LBK,10,2010,4726,2409,2317,505,81,77,332
LBK,10,2010,9199,4640,4559,1046,393,351,515
LBK,10,2010,3536,1869,1667,359,77,87,258
HKK,10,2010,5729,2934,2795,803,381,431,629
HKK,10,2010,3139,1714,1425,397,142,130,284
HKK,10,2010,4079,2176,1903,598,366,338,340
HKK,10,2010,2514,1398,1116,329,73,123,238
HKK,10,2010,5269,2671,2598,673,182,196,421
PAK,10,2010,4692,2476,2216,570,87,203,414
PAK,10,2010,5773,3007,2766,822,543,374,533
PAK,10,2010,5720,2925,2795,609,173,169,486
PAK,10,2010,6469,3351,3118,629,307,278,516
VYS,10,2010,4123,2274,1849,415,96,46,371
VYS,10,2010,5081,2624,2457,609,183,212,518
VYS,10,2010,2344,1318,1026,312,70,53,233
VYS,10,2010,6844,3620,3224,740,97,100,653
VYS,10,2010,5692,2960,2732,576,60,113,583
JHM,10,2010,5142,2642,2500,451,121,139,494
JHM,10,2010,18827,9538,9289,1814,1353,1209,914
JHM,10,2010,8141,4170,3971,800,158,158,824
JHM,10,2010,6095,2979,3116,687,163,168,658
JHM,10,2010,11341,5421,5920,960,212,196,993
JHM,10,2010,3772,1944,1828,448,94,74,384
JHM,10,2010,6611,3505,3106,912,204,247,605
OLK,10,2010,2911,1589,1322,357,39,39,221
OLK,10,2010,11644,5971,5673,1091,403,467,1005
OLK,10,2010,5734,3321,2413,651,94,109,460
OLK,10,2010,7976,4027,3949,621,159,128,610
OLK,10,2010,7429,3804,3625,729,120,174,493
ZLK,10,2010,6100,2960,3140,534,150,168,515
ZLK,10,2010,6697,3508,3189,639,122,111,407
ZLK,10,2010,8096,3879,4217,755,243,211,697
ZLK,10,2010,8718,4583,4135,830,265,250,813
MSK,10,2010,7531,4019,3512,675,117,116,589
MSK,10,2010,9390,4850,4540,1036,302,411,854
MSK,10,2010,20327,10388,9939,1650,254,214,1426
MSK,10,2010,8367,4023,4344,898,166,213,544
MSK,10,2010,9176,4705,4471,822,199,210,880
MSK,10,2010,20632,10140,10492,1780,523,617,1365
PHA,11,2010,32213,16060,16153,4591,2563,2470,1801
STC,11,2010,2721,1385,1336,484,88,133,284
STC,11,2010,3296,1682,1614,398,62,59,167
STC,11,2010,7836,3989,3847,838,117,100,624
STC,11,2010,4880,2475,2405,806,124,126,109
STC,11,2010,3512,1843,1669,572,105,177,150
STC,11,2010,4896,2605,2291,578,102,82,410
STC,11,2010,3814,2137,1677,529,156,170,179
STC,11,2010,4683,2343,2340,678,94,104,340
STC,11,2010,3135,1595,1540,567,159,203,289
STC,11,2010,2608,1361,1247,388,102,66,171
STC,11,2010,5936,2802,3134,875,101,141,451
STC,11,2010,2413,1301,1112,351,24,36,230
JHC,11,2010,5845,3066,2779,986,452,441,613
JHC,11,2010,3377,1681,1696,567,42,52,232
JHC,11,2010,3329,1958,1371,698,67,77,315
JHC,11,2010,2566,1413,1153,571,115,157,221
JHC,11,2010,1817,846,971,456,87,110,152
JHC,11,2010,3278,1673,1605,431,55,81,202
JHC,11,2010,4745,2516,2229,563,128,166,363
PLK,11,2010,2768,1450,1318,377,82,71,181
PLK,11,2010,4095,2119,1976,713,143,133,293
PLK,11,2010,6902,3547,3355,946,492,515,360
PLK,11,2010,2050,1069,981,323,22,60,183
PLK,11,2010,2950,1597,1353,464,28,37,241
PLK,11,2010,1817,1024,793,264,40,39,136
PLK,11,2010,3549,1803,1746,466,71,42,231
KVK,11,2010,5074,2358,2716,753,93,117,267
KVK,11,2010,7122,3368,3754,851,127,131,462
KVK,11,2010,6325,3025,3300,821,119,121,462
ULK,11,2010,10076,4968,5108,1311,96,93,593
ULK,11,2010,8627,4416,4211,1052,118,187,488
ULK,11,2010,6641,3410,3231,1047,124,152,446
ULK,11,2010,5907,2898,3009,862,107,86,391
ULK,11,2010,9611,5036,4575,1040,99,90,592
ULK,11,2010,8650,4467,4183,789,99,101,595
ULK,11,2010,8783,4121,4662,844,203,152,531
LBK,11,2010,6296,3452,2844,762,164,219,414
LBK,11,2010,4694,2389,2305,522,84,83,303
LBK,11,2010,9189,4631,4558,1231,300,439,461
LBK,11,2010,3635,1860,1775,524,152,175,234
HKK,11,2010,5849,2967,2882,868,428,437,583
HKK,11,2010,3181,1671,1510,524,106,110,248
HKK,11,2010,4276,2209,2067,762,107,212,303
HKK,11,2010,2530,1409,1121,404,65,91,199
HKK,11,2010,5614,2803,2811,924,232,238,415
PAK,11,2010,4964,2547,2417,802,132,144,403
PAK,11,2010,5890,2964,2926,999,542,550,494
PAK,11,2010,5917,2915,3002,769,235,243,456
PAK,11,2010,6472,3250,3222,821,267,315,452
VYS,11,2010,4232,2281,1951,574,61,74,349
VYS,11,2010,5129,2583,2546,627,162,223,475
VYS,11,2010,2456,1298,1158,454,58,46,215
VYS,11,2010,7080,3699,3381,889,65,91,626
VYS,11,2010,5928,2992,2936,774,162,153,550
JHM,11,2010,5122,2607,2515,550,180,123,447
JHM,11,2010,18746,9452,9294,1721,1369,1657,903
JHM,11,2010,8292,4188,4104,1047,740,499,767
JHM,11,2010,6713,3190,3523,1178,160,183,636
JHM,11,2010,11610,5439,6171,1122,152,261,932
JHM,11,2010,3865,1958,1907,524,55,68,373
JHM,11,2010,7525,3950,3575,1610,232,363,581
OLK,11,2010,3446,1778,1668,779,24,50,216
OLK,11,2010,12036,6031,6005,1560,479,404,946
OLK,11,2010,5791,3314,2477,684,128,147,445
OLK,11,2010,8135,4027,4108,894,139,226,587
OLK,11,2010,7688,3832,3856,925,156,121,466
ZLK,11,2010,6110,2931,3179,651,142,151,476
ZLK,11,2010,6859,3520,3339,851,134,189,373
ZLK,11,2010,8305,3946,4359,1043,253,333,631
ZLK,11,2010,8748,4570,4178,1061,157,221,718
MSK,11,2010,8039,4189,3850,1059,142,130,575
MSK,11,2010,9615,4849,4766,1327,342,437,790
MSK,11,2010,20242,10365,9877,1891,180,258,1367
MSK,11,2010,8391,4002,4389,977,174,269,503
MSK,11,2010,9411,4765,4646,1052,133,213,849
MSK,11,2010,20772,10128,10644,1985,817,506,1302
PHA,12,2010,33433,16669,16764,5203,2244,2245,1717
STC,12,2010,3217,1508,1709,802,30,57,280
STC,12,2010,3494,1743,1751,528,105,66,166
STC,12,2010,8286,4098,4188,1061,115,92,613
STC,12,2010,5537,2641,2896,1030,88,168,119
STC,12,2010,4025,1963,2062,802,123,69,144
STC,12,2010,5251,2710,2541,716,49,69,406
STC,12,2010,4076,2244,1832,693,117,144,153
STC,12,2010,5238,2514,2724,882,347,345,352
STC,12,2010,3409,1708,1701,656,448,193,274
STC,12,2010,2665,1360,1305,439,41,87,165
STC,12,2010,6779,2944,3835,1313,114,100,442
STC,12,2010,2739,1402,1337,513,22,22,218
JHC,12,2010,6692,3268,3424,1455,287,283,588
JHC,12,2010,4042,1833,2209,988,36,38,239
JHC,12,2010,4179,2104,2075,1168,73,52,321
JHC,12,2010,3169,1546,1623,871,101,69,209
JHC,12,2010,2122,892,1230,542,52,71,153
JHC,12,2010,3954,1779,2175,909,69,54,196
JHC,12,2010,5387,2692,2695,924,109,134,378
PLK,12,2010,3184,1498,1686,669,32,39,179
PLK,12,2010,4827,2193,2634,1130,164,111,295
PLK,12,2010,7570,3801,3769,1354,207,273,352
PLK,12,2010,2290,1092,1198,453,25,35,189
PLK,12,2010,3292,1647,1645,651,70,25,229
PLK,12,2010,2081,1104,977,461,64,12,128
PLK,12,2010,4023,1891,2132,699,58,80,236
KVK,12,2010,5574,2524,3050,893,62,79,271
KVK,12,2010,7591,3488,4103,1015,88,102,447
KVK,12,2010,6757,3220,3537,895,31,64,455
ULK,12,2010,10730,5126,5604,1385,87,84,605
ULK,12,2010,9246,4566,4680,1327,84,97,488
ULK,12,2010,7324,3597,3727,1259,61,122,443
ULK,12,2010,6495,3027,3468,1019,54,37,392
ULK,12,2010,9871,5119,4752,997,59,75,584
ULK,12,2010,9171,4700,4471,1132,75,67,577
ULK,12,2010,9110,4214,4896,925,160,97,517
LBK,12,2010,6937,3731,3206,1150,72,136,416
LBK,12,2010,4962,2451,2511,664,53,62,299
LBK,12,2010,9799,4807,4992,1401,260,269,446
LBK,12,2010,3955,1878,2077,709,55,64,229
HKK,12,2010,6770,3107,3663,1476,350,468,555
HKK,12,2010,3757,1765,1992,895,61,103,263
HKK,12,2010,4881,2264,2617,1102,112,115,271
HKK,12,2010,2984,1512,1472,783,45,47,205
HKK,12,2010,6286,2948,3338,1254,157,158,409
PAK,12,2010,6206,2678,3528,1598,75,61,396
PAK,12,2010,6709,3161,3548,1474,307,463,485
PAK,12,2010,7045,3015,4030,1526,107,242,464
PAK,12,2010,7399,3372,4027,1461,186,196,439
VYS,12,2010,5135,2435,2700,1245,36,48,345
VYS,12,2010,5980,2689,3291,1267,143,169,476
VYS,12,2010,3003,1391,1612,811,66,69,212
VYS,12,2010,8429,3983,4446,1759,36,47,625
VYS,12,2010,6863,3189,3674,1372,45,71,538
JHM,12,2010,5665,2744,2921,887,43,112,461
JHM,12,2010,19711,9765,9946,2319,634,1001,887
JHM,12,2010,9086,4369,4717,1451,113,393,752
JHM,12,2010,8087,3518,4569,1806,95,109,639
JHM,12,2010,13398,5764,7634,2427,93,122,938
JHM,12,2010,4355,2021,2334,876,77,49,362
JHM,12,2010,9040,4313,4727,2059,101,163,605
OLK,12,2010,4055,1862,2193,844,13,18,221
OLK,12,2010,13676,6326,7350,2591,270,337,942
OLK,12,2010,6476,3465,3011,1140,40,63,454
OLK,12,2010,9188,4205,4983,1595,85,104,607
OLK,12,2010,8722,4046,4676,1556,151,124,479
ZLK,12,2010,6720,3027,3693,1048,93,74,456
ZLK,12,2010,7675,3666,4009,1288,52,102,362
ZLK,12,2010,9297,4130,5167,1515,257,249,655
ZLK,12,2010,9694,4845,4849,1618,172,136,720
MSK,12,2010,9092,4340,4752,1507,85,110,594
MSK,12,2010,10710,5067,5643,1971,164,229,781
MSK,12,2010,20940,10453,10487,2089,179,125,1286
MSK,12,2010,9235,4144,5091,1551,184,131,466
MSK,12,2010,11067,5004,6063,2254,76,108,872
MSK,12,2010,21732,10325,11407,2423,457,681,1225
PHA,1,2011,33663,16654,17009,4864,2570,3257,1646
STC,1,2011,3423,1551,1872,633,86,53,264
STC,1,2011,3527,1740,1787,451,92,121,176
STC,1,2011,8513,4157,4356,1101,204,151,607
STC,1,2011,5632,2616,3016,678,165,124,113
STC,1,2011,4097,1929,2168,489,298,147,136
STC,1,2011,5396,2722,2674,663,147,113,398
STC,1,2011,4105,2208,1897,553,162,136,143
STC,1,2011,5285,2510,2775,551,223,159,337
STC,1,2011,3430,1645,1785,616,209,173,263
STC,1,2011,2699,1349,1350,452,58,67,157
STC,1,2011,7005,2943,4062,846,122,124,439
STC,1,2011,2811,1419,1392,359,37,36,216
JHC,1,2011,6821,3203,3618,1061,345,373,534
JHC,1,2011,4222,1838,2384,583,36,43,232
JHC,1,2011,4459,2116,2343,723,123,116,316
JHC,1,2011,3333,1546,1787,526,101,127,207
JHC,1,2011,2244,869,1375,443,65,71,150
JHC,1,2011,4112,1746,2366,544,85,167,187
JHC,1,2011,5729,2714,3015,862,125,128,370
PLK,1,2011,3324,1505,1819,432,71,87,177
PLK,1,2011,5006,2204,2802,650,146,198,302
PLK,1,2011,7666,3802,3864,1057,464,392,333
PLK,1,2011,2385,1083,1302,339,47,34,181
PLK,1,2011,3456,1615,1841,584,62,86,217
PLK,1,2011,2080,1087,993,253,52,98,134
PLK,1,2011,4086,1863,2223,477,37,100,229
KVK,1,2011,5929,2597,3332,866,107,98,273
KVK,1,2011,7778,3485,4293,852,187,152,443
KVK,1,2011,6935,3222,3713,720,122,97,476
ULK,1,2011,10931,5085,5846,1054,97,101,616
ULK,1,2011,9420,4650,4770,1023,144,150,490
ULK,1,2011,7456,3576,3880,823,192,136,429
ULK,1,2011,6588,3067,3521,677,148,152,409
ULK,1,2011,9911,5112,4799,879,123,107,565
ULK,1,2011,9337,4713,4624,949,119,113,581
ULK,1,2011,9117,4169,4948,769,149,164,507
LBK,1,2011,6975,3683,3292,754,159,118,403
LBK,1,2011,4958,2395,2563,588,123,116,280
LBK,1,2011,9928,4811,5117,1278,418,327,428
LBK,1,2011,3960,1798,2162,487,91,105,220
HKK,1,2011,6819,3014,3805,935,568,381,532
HKK,1,2011,3780,1709,2071,460,132,62,246
HKK,1,2011,4995,2226,2769,744,131,128,245
HKK,1,2011,3040,1496,1544,443,79,80,199
HKK,1,2011,6228,2824,3404,731,136,213,390
PAK,1,2011,6393,2680,3713,779,136,114,383
PAK,1,2011,6767,3080,3687,1014,382,306,474
PAK,1,2011,7392,3017,4375,904,222,279,467
PAK,1,2011,7416,3314,4102,838,192,150,418
VYS,1,2011,5242,2421,2821,548,116,75,340
VYS,1,2011,6185,2664,3521,792,261,211,476
VYS,1,2011,3113,1390,1723,477,52,54,195
VYS,1,2011,8630,3919,4711,823,66,57,620
VYS,1,2011,7035,3143,3892,766,219,116,522
JHM,1,2011,5662,2694,2968,585,111,147,411
JHM,1,2011,19564,9596,9968,1938,1387,1268,830
JHM,1,2011,9050,4227,4823,1066,240,307,712
JHM,1,2011,8179,3473,4706,817,199,117,635
JHM,1,2011,13582,5660,7922,1236,207,121,925
JHM,1,2011,4464,2000,2464,565,124,105,335
JHM,1,2011,9618,4306,5312,1331,135,119,587
OLK,1,2011,4204,1837,2367,538,31,20,204
OLK,1,2011,14008,6288,7720,1636,485,510,888
OLK,1,2011,6731,3492,3239,769,191,75,464
OLK,1,2011,9504,4214,5290,1031,194,145,576
OLK,1,2011,8767,4019,4748,825,203,214,468
ZLK,1,2011,6911,3000,3911,835,153,160,434
ZLK,1,2011,7792,3585,4207,842,161,130,345
ZLK,1,2011,9369,4071,5298,980,235,229,633
ZLK,1,2011,9862,4745,5117,1116,363,330,701
MSK,1,2011,9515,4383,5132,1033,145,146,601
MSK,1,2011,10795,4985,5810,1277,438,298,743
MSK,1,2011,21078,10420,10658,1951,371,275,1233
MSK,1,2011,9162,3999,5163,1019,188,224,433
MSK,1,2011,11276,4906,6370,1253,169,156,844
MSK,1,2011,22003,10360,11643,2118,622,826,1232
PHA,2,2011,33814,16632,17182,4464,2718,2226,1702
STC,2,2011,3472,1547,1925,431,58,70,267
STC,2,2011,3481,1720,1761,327,77,77,160
STC,2,2011,8423,4117,4306,778,92,143,579
STC,2,2011,5583,2638,2945,493,169,103,116
STC,2,2011,4022,1890,2132,313,73,209,125
STC,2,2011,5345,2721,2624,462,57,105,402
STC,2,2011,3955,2113,1842,370,124,122,138
STC,2,2011,5196,2474,2722,381,148,234,341
STC,2,2011,3443,1650,1793,509,238,174,271
STC,2,2011,2723,1381,1342,389,79,102,168
STC,2,2011,6968,2913,4055,550,204,137,483
STC,2,2011,2785,1377,1408,241,68,30,211
JHC,2,2011,6925,3223,3702,897,341,278,574
JHC,2,2011,4202,1823,2379,337,32,26,235
JHC,2,2011,4439,2094,2345,405,49,46,299
JHC,2,2011,3333,1553,1780,330,127,82,207
JHC,2,2011,2213,858,1355,248,79,47,154
JHC,2,2011,4026,1691,2335,257,61,91,178
JHC,2,2011,5685,2678,3007,443,165,111,376
PLK,2,2011,3224,1466,1758,241,59,52,163
PLK,2,2011,5006,2217,2789,419,115,140,317
PLK,2,2011,7428,3689,3739,808,542,612,338
PLK,2,2011,2332,1074,1258,217,21,31,171
PLK,2,2011,3340,1568,1772,322,68,77,209
PLK,2,2011,2004,1040,964,197,42,54,124
PLK,2,2011,4018,1853,2165,296,77,108,232
KVK,2,2011,5765,2523,3242,437,158,100,255
KVK,2,2011,7705,3437,4268,573,191,151,441
KVK,2,2011,6874,3173,3701,503,98,85,481
ULK,2,2011,10831,5008,5823,670,201,204,641
ULK,2,2011,9313,4589,4724,711,110,120,464
ULK,2,2011,7420,3526,3894,579,98,153,422
ULK,2,2011,6569,3074,3495,552,27,33,411
ULK,2,2011,9765,4984,4781,636,113,114,549
ULK,2,2011,9285,4664,4621,676,116,120,560
ULK,2,2011,9378,4283,5095,944,130,153,504
LBK,2,2011,7004,3690,3314,637,123,107,401
LBK,2,2011,4907,2381,2526,476,99,86,285
LBK,2,2011,9817,4750,5067,1015,275,397,450
LBK,2,2011,3944,1806,2138,305,64,65,219
HKK,2,2011,6798,3000,3798,672,583,397,559
HKK,2,2011,3691,1658,2033,289,108,133,238
HKK,2,2011,4977,2237,2740,487,147,117,229
HKK,2,2011,2975,1438,1537,277,90,73,186
HKK,2,2011,6134,2780,3354,489,222,148,385
PAK,2,2011,6235,2602,3633,396,197,113,382
PAK,2,2011,6671,3031,3640,688,608,652,460
PAK,2,2011,7321,2989,4332,438,176,112,483
PAK,2,2011,7358,3280,4078,607,239,206,419
VYS,2,2011,5174,2366,2808,333,60,125,340
VYS,2,2011,6035,2583,3452,395,224,202,482
VYS,2,2011,3083,1357,1726,303,51,39,186
VYS,2,2011,8508,3843,4665,492,92,70,625
VYS,2,2011,6925,3098,3827,471,104,192,546
JHM,2,2011,5590,2633,2957,440,129,99,410
JHM,2,2011,19491,9577,9914,1669,880,1221,858
JHM,2,2011,8858,4108,4750,822,256,137,697
JHM,2,2011,8137,3439,4698,543,145,195,643
JHM,2,2011,13382,5511,7871,822,243,208,891
JHM,2,2011,4457,2015,2442,406,102,93,339
JHM,2,2011,9571,4282,5289,646,119,122,595
OLK,2,2011,4175,1793,2382,251,17,20,216
OLK,2,2011,13837,6192,7645,1027,662,399,916
OLK,2,2011,6635,3438,3197,486,103,177,450
OLK,2,2011,9428,4179,5249,609,205,163,578
OLK,2,2011,8656,3958,4698,579,151,184,434
ZLK,2,2011,6910,3001,3909,505,173,147,462
ZLK,2,2011,7714,3530,4184,614,140,88,357
ZLK,2,2011,9270,3991,5279,620,221,166,632
ZLK,2,2011,9687,4617,5070,732,222,245,695
MSK,2,2011,9350,4312,5038,530,100,142,594
MSK,2,2011,10757,4938,5819,960,347,348,738
MSK,2,2011,21055,10378,10677,1557,181,169,1218
MSK,2,2011,8955,3928,5027,636,225,163,445
MSK,2,2011,11211,4878,6333,853,96,137,830
MSK,2,2011,21923,10324,11599,1673,787,743,1325
PHA,3,2011,33713,16622,17091,4638,3403,3020,1717
STC,3,2011,3271,1464,1807,384,105,108,266
STC,3,2011,3406,1669,1737,377,85,42,157
STC,3,2011,8312,4084,4228,815,136,103,600
STC,3,2011,5389,2569,2820,529,186,188,115
STC,3,2011,3964,1892,2072,434,186,201,123
STC,3,2011,5232,2677,2555,561,122,111,389
STC,3,2011,3870,2072,1798,436,166,127,132
STC,3,2011,5084,2438,2646,476,413,401,342
STC,3,2011,3328,1608,1720,450,179,144,255
STC,3,2011,2701,1353,1348,407,92,61,159
STC,3,2011,6619,2846,3773,586,234,196,475
STC,3,2011,2700,1340,1360,272,21,75,193
JHC,3,2011,6732,3163,3569,860,277,312,601
JHC,3,2011,3968,1775,2193,345,85,38,225
JHC,3,2011,4112,1991,2121,416,99,84,288
JHC,3,2011,3059,1468,1591,396,202,216,194
JHC,3,2011,2095,848,1247,285,66,100,157
JHC,3,2011,3696,1671,2025,288,150,121,176
JHC,3,2011,5535,2655,2880,504,183,161,373
PLK,3,2011,2992,1410,1582,277,146,124,139
PLK,3,2011,4671,2172,2499,413,141,155,296
PLK,3,2011,7191,3537,3654,906,422,430,317
PLK,3,2011,2208,1037,1171,252,44,49,163
PLK,3,2011,3136,1489,1647,356,50,46,186
PLK,3,2011,1822,952,870,192,39,36,119
PLK,3,2011,3801,1801,2000,299,109,93,214
KVK,3,2011,5468,2375,3093,530,177,155,254
KVK,3,2011,7414,3309,4105,599,242,192,418
KVK,3,2011,6657,3063,3594,531,109,78,459
ULK,3,2011,10702,4990,5712,823,184,160,646
ULK,3,2011,9042,4464,4578,834,198,120,460
ULK,3,2011,7058,3372,3686,591,186,177,413
ULK,3,2011,6223,2935,3288,461,93,78,387
ULK,3,2011,9578,4904,4674,705,118,85,545
ULK,3,2011,9025,4531,4494,724,155,163,528
ULK,3,2011,9274,4253,5021,709,123,99,507
LBK,3,2011,6949,3699,3250,719,162,165,402
LBK,3,2011,4800,2338,2462,435,94,75,286
LBK,3,2011,9578,4629,4949,975,433,386,461
LBK,3,2011,3873,1794,2079,358,107,93,227
HKK,3,2011,6486,2970,3516,729,538,647,561
HKK,3,2011,3487,1606,1881,289,123,107,222
HKK,3,2011,4835,2166,2669,508,170,173,213
HKK,3,2011,2847,1406,1441,308,137,105,170
HKK,3,2011,6066,2767,3299,655,171,159,374
PAK,3,2011,5816,2532,3284,463,200,177,366
PAK,3,2011,6412,2981,3431,767,464,345,444
PAK,3,2011,6748,2827,3921,435,242,203,459
PAK,3,2011,7001,3190,3811,530,274,246,409
VYS,3,2011,4811,2328,2483,381,84,74,347
VYS,3,2011,5809,2520,3289,472,231,227,484
VYS,3,2011,2869,1290,1579,278,68,63,183
VYS,3,2011,8121,3750,4371,548,89,80,624
VYS,3,2011,6663,3029,3634,478,145,120,519
JHM,3,2011,5351,2513,2838,444,109,130,416
JHM,3,2011,19201,9473,9728,1651,970,1095,845
JHM,3,2011,8488,4029,4459,809,188,298,690
JHM,3,2011,7694,3244,4450,629,168,181,612
JHM,3,2011,12936,5366,7570,824,191,189,878
JHM,3,2011,4231,1911,2320,397,83,83,319
JHM,3,2011,9083,4122,4961,656,156,156,562
OLK,3,2011,3942,1714,2228,273,89,55,208
OLK,3,2011,13298,6054,7244,1065,646,610,918
OLK,3,2011,6249,3276,2973,512,103,125,440
OLK,3,2011,8961,4072,4889,583,177,206,558
OLK,3,2011,8316,3859,4457,569,399,175,415
ZLK,3,2011,6696,2945,3751,480,144,174,456
ZLK,3,2011,7426,3486,3940,620,153,122,370
ZLK,3,2011,8961,3874,5087,676,297,270,596
ZLK,3,2011,9432,4500,4932,837,294,216,703
MSK,3,2011,9006,4225,4781,532,141,84,584
MSK,3,2011,10479,4878,5601,1023,426,402,705
MSK,3,2011,20882,10332,10550,1549,389,313,1196
MSK,3,2011,8560,3845,4715,731,353,291,411
MSK,3,2011,10722,4746,5976,770,236,159,808
MSK,3,2011,21629,10194,11435,1844,959,734,1322
PHA,4,2011,33104,16323,16781,4206,2891,2523,1649
STC,4,2011,2925,1404,1521,372,216,170,241
STC,4,2011,3174,1592,1582,299,54,55,158
STC,4,2011,8064,4012,4052,683,123,102,567
STC,4,2011,5132,2551,2581,552,120,109,112
STC,4,2011,3630,1839,1791,432,71,177,116
STC,4,2011,4925,2545,2380,434,71,53,367
STC,4,2011,3737,2018,1719,361,141,116,126
STC,4,2011,4760,2358,2402,417,115,122,308
STC,4,2011,3254,1582,1672,455,163,260,242
STC,4,2011,2659,1348,1311,390,65,76,158
STC,4,2011,6028,2764,3264,527,140,151,449
STC,4,2011,2496,1289,1207,245,23,16,185
JHC,4,2011,6257,3050,3207,779,303,302,588
JHC,4,2011,3499,1650,1849,322,164,88,202
JHC,4,2011,3493,1870,1623,392,99,73,268
JHC,4,2011,2640,1361,1279,304,138,113,162
JHC,4,2011,1842,805,1037,246,84,59,144
JHC,4,2011,3431,1639,1792,307,89,83,167
JHC,4,2011,5156,2592,2564,450,213,146,361
PLK,4,2011,2697,1349,1348,245,98,82,119
PLK,4,2011,4122,2006,2116,417,154,101,267
PLK,4,2011,7001,3513,3488,823,393,309,289
PLK,4,2011,2035,993,1042,216,50,27,167
PLK,4,2011,2862,1418,1444,322,47,37,171
PLK,4,2011,1685,918,767,195,35,32,96
PLK,4,2011,3441,1692,1749,266,89,96,204
KVK,4,2011,5079,2256,2823,409,95,91,238
KVK,4,2011,7024,3184,3840,576,228,135,392
KVK,4,2011,6500,3033,3467,560,69,92,453
ULK,4,2011,10131,4848,5283,691,72,74,609
ULK,4,2011,8783,4399,4384,850,198,164,469
ULK,4,2011,6464,3187,3277,567,121,166,373
ULK,4,2011,5853,2816,3037,465,77,42,381
ULK,4,2011,9445,4844,4601,686,125,86,509
ULK,4,2011,8699,4378,4321,671,109,103,498
ULK,4,2011,9133,4229,4904,666,112,101,516
LBK,4,2011,6787,3677,3110,745,191,176,386
LBK,4,2011,4698,2332,2366,464,112,92,288
LBK,4,2011,9311,4573,4738,901,544,521,454
LBK,4,2011,3663,1766,1897,391,68,75,208
HKK,4,2011,5942,2864,3078,656,576,546,482
HKK,4,2011,3090,1548,1542,318,97,108,213
HKK,4,2011,4387,2053,2334,468,153,141,209
HKK,4,2011,2547,1348,1199,333,174,93,161
HKK,4,2011,5737,2745,2992,631,173,150,342
PAK,4,2011,5022,2417,2605,414,204,129,336
PAK,4,2011,5984,2933,3051,729,360,428,415
PAK,4,2011,5959,2688,3271,432,178,168,429
PAK,4,2011,6499,3113,3386,635,333,244,411
VYS,4,2011,4255,2220,2035,325,78,86,301
VYS,4,2011,5073,2415,2658,431,272,303,438
VYS,4,2011,2420,1221,1199,259,73,54,165
VYS,4,2011,7138,3471,3667,515,123,111,601
VYS,4,2011,5948,2897,3051,394,137,92,493
JHM,4,2011,5083,2455,2628,416,93,94,390
JHM,4,2011,18924,9385,9539,1555,849,839,828
JHM,4,2011,8059,3957,4102,796,194,94,676
JHM,4,2011,6929,3076,3853,549,183,159,557
JHM,4,2011,11992,5155,6837,860,265,244,844
JHM,4,2011,3968,1865,2103,416,78,85,297
JHM,4,2011,8003,3872,4131,681,230,120,540
OLK,4,2011,3388,1607,1781,269,24,35,202
OLK,4,2011,12377,5931,6446,997,747,493,874
OLK,4,2011,5967,3232,2735,473,71,80,419
OLK,4,2011,8368,3990,4378,537,158,124,539
OLK,4,2011,7607,3660,3947,604,154,305,393
ZLK,4,2011,6256,2899,3357,525,140,98,440
ZLK,4,2011,6875,3413,3462,594,111,73,352
ZLK,4,2011,8264,3737,4527,597,269,169,550
ZLK,4,2011,8784,4332,4452,778,337,226,648
MSK,4,2011,8278,4027,4251,557,98,100,532
MSK,4,2011,9734,4701,5033,963,496,355,664
MSK,4,2011,20552,10217,10335,1474,366,203,1140
MSK,4,2011,7945,3700,4245,730,221,256,388
MSK,4,2011,9788,4486,5302,766,191,170,749
MSK,4,2011,21081,10067,11014,1703,606,589,1283
PHA,5,2011,32295,15968,16327,3887,2611,2853,1417
STC,5,2011,2736,1358,1378,378,114,100,183
STC,5,2011,3075,1578,1497,309,120,116,132
STC,5,2011,7930,3972,3958,753,91,127,475
STC,5,2011,4994,2549,2445,493,179,191,102
STC,5,2011,3423,1810,1613,348,160,72,97
STC,5,2011,4778,2504,2274,416,126,123,315
STC,5,2011,3653,1985,1668,421,191,126,123
STC,5,2011,4648,2351,2297,411,226,118,264
STC,5,2011,3090,1510,1580,442,160,165,211
STC,5,2011,2535,1292,1243,324,97,66,140
STC,5,2011,5694,2692,3002,490,147,153,380
STC,5,2011,2444,1288,1156,252,22,31,157
JHC,5,2011,6012,3046,2966,816,335,244,522
JHC,5,2011,3149,1522,1627,285,87,109,191
JHC,5,2011,3153,1770,1383,346,101,101,219
JHC,5,2011,2345,1248,1097,285,139,155,129
JHC,5,2011,1631,772,859,224,90,76,113
JHC,5,2011,3199,1612,1587,274,79,79,152
JHC,5,2011,4901,2562,2339,424,206,207,310
PLK,5,2011,2513,1300,1213,248,76,64,101
PLK,5,2011,3692,1873,1819,345,151,133,205
PLK,5,2011,6825,3537,3288,842,409,518,250
PLK,5,2011,1907,971,936,208,53,30,138
PLK,5,2011,2670,1394,1276,322,57,22,143
PLK,5,2011,1563,861,702,175,44,40,88
PLK,5,2011,3324,1658,1666,277,93,55,181
KVK,5,2011,4786,2182,2604,483,156,108,218
KVK,5,2011,6750,3110,3640,564,241,161,347
KVK,5,2011,6275,2992,3283,518,78,77,402
ULK,5,2011,9581,4635,4946,655,106,75,526
ULK,5,2011,8565,4321,4244,749,179,158,436
ULK,5,2011,6142,3133,3009,542,202,205,327
ULK,5,2011,5661,2786,2875,506,71,71,317
ULK,5,2011,9361,4832,4529,790,133,118,476
ULK,5,2011,8433,4290,4143,623,196,110,448
ULK,5,2011,8973,4174,4799,656,122,107,471
LBK,5,2011,6367,3495,2872,471,407,319,332
LBK,5,2011,4488,2291,2197,426,91,68,261
LBK,5,2011,9066,4544,4522,870,482,410,420
LBK,5,2011,3460,1724,1736,317,118,86,172
HKK,5,2011,5610,2758,2852,661,612,599,426
HKK,5,2011,2864,1508,1356,331,89,83,189
HKK,5,2011,4124,2036,2088,421,151,152,195
HKK,5,2011,2421,1339,1082,305,129,105,140
HKK,5,2011,5338,2642,2696,498,167,166,282
PAK,5,2011,4588,2361,2227,458,211,144,305
PAK,5,2011,5645,2828,2817,723,451,453,365
PAK,5,2011,5540,2631,2909,403,175,262,364
PAK,5,2011,6106,3021,3085,589,329,285,346
VYS,5,2011,3982,2177,1805,345,74,67,245
VYS,5,2011,4678,2319,2359,395,403,308,379
VYS,5,2011,2084,1131,953,222,64,35,133
VYS,5,2011,6659,3427,3232,490,109,131,522
VYS,5,2011,5600,2860,2740,425,121,114,413
JHM,5,2011,4860,2416,2444,385,141,88,307
JHM,5,2011,18673,9363,9310,1644,1001,1032,762
JHM,5,2011,7713,3880,3833,733,176,181,582
JHM,5,2011,6483,2963,3520,596,180,157,474
JHM,5,2011,11313,5039,6274,763,335,197,670
JHM,5,2011,3713,1816,1897,360,122,112,252
JHM,5,2011,7208,3576,3632,549,212,170,462
OLK,5,2011,3040,1504,1536,215,27,37,174
OLK,5,2011,11728,5792,5936,931,754,829,728
OLK,5,2011,5740,3132,2608,460,128,109,349
OLK,5,2011,7921,3928,3993,534,165,209,439
OLK,5,2011,7170,3560,3610,532,174,209,318
ZLK,5,2011,5983,2871,3112,499,183,169,399
ZLK,5,2011,6515,3371,3144,546,148,166,304
ZLK,5,2011,7831,3630,4201,621,312,254,445
ZLK,5,2011,8190,4193,3997,714,309,307,527
MSK,5,2011,7886,4001,3885,573,120,98,469
MSK,5,2011,9177,4566,4611,905,533,452,546
MSK,5,2011,20152,10065,10087,1451,522,286,959
MSK,5,2011,7491,3622,3869,673,371,243,330
MSK,5,2011,9308,4431,4877,747,233,220,661
MSK,5,2011,20535,9911,10624,1765,899,704,1104
PHA,6,2011,32101,16015,16086,4175,2684,2514,1314
STC,6,2011,2647,1352,1295,335,68,74,149
STC,6,2011,3058,1593,1465,342,104,101,125
STC,6,2011,7969,4043,3926,786,78,74,415
STC,6,2011,4915,2549,2366,505,151,137,90
STC,6,2011,3349,1805,1544,342,97,87,94
STC,6,2011,4743,2511,2232,469,107,101,268
STC,6,2011,3561,1955,1606,380,188,159,111
STC,6,2011,4652,2394,2258,451,279,345,230
STC,6,2011,3069,1524,1545,439,307,290,195
STC,6,2011,2564,1339,1225,375,75,44,135
STC,6,2011,5563,2706,2857,500,154,139,301
STC,6,2011,2427,1294,1133,237,59,19,131
JHC,6,2011,5853,3051,2802,763,291,247,456
JHC,6,2011,3010,1474,1536,298,92,40,155
JHC,6,2011,3010,1737,1273,390,70,106,173
JHC,6,2011,2288,1258,1030,301,104,102,115
JHC,6,2011,1571,774,797,239,69,92,99
JHC,6,2011,3088,1616,1472,282,131,89,126
JHC,6,2011,4828,2567,2261,554,188,202,244
PLK,6,2011,2466,1302,1164,265,88,70,89
PLK,6,2011,3572,1863,1709,390,97,92,172
PLK,6,2011,6856,3597,3259,866,558,523,217
PLK,6,2011,1866,964,902,228,45,31,116
PLK,6,2011,2637,1402,1235,318,56,49,132
PLK,6,2011,1519,844,675,198,74,63,73
PLK,6,2011,3183,1592,1591,230,74,38,149
KVK,6,2011,4632,2151,2481,473,133,168,185
KVK,6,2011,6618,3073,3545,601,196,262,301
KVK,6,2011,6131,2976,3155,488,57,116,333
ULK,6,2011,9327,4596,4731,719,89,85,441
ULK,6,2011,8475,4336,4139,771,201,238,362
ULK,6,2011,5900,3060,2840,530,212,185,257
ULK,6,2011,5600,2782,2818,549,53,48,303
ULK,6,2011,9255,4789,4466,677,108,97,423
ULK,6,2011,8172,4192,3980,610,122,145,383
ULK,6,2011,8886,4144,4742,605,157,148,390
LBK,6,2011,6139,3396,2743,510,129,190,276
LBK,6,2011,4349,2267,2082,398,81,89,236
LBK,6,2011,8902,4547,4355,963,404,365,389
LBK,6,2011,3381,1738,1643,364,138,94,140
HKK,6,2011,5567,2812,2755,731,522,565,398
HKK,6,2011,2773,1475,1298,299,72,88,161
HKK,6,2011,4019,2032,1987,450,186,131,169
HKK,6,2011,2346,1329,1017,306,211,105,122
HKK,6,2011,5238,2638,2600,540,247,206,235
PAK,6,2011,4450,2383,2067,509,158,172,258
PAK,6,2011,5560,2877,2683,738,334,422,318
PAK,6,2011,5334,2577,2757,440,221,218,298
PAK,6,2011,5858,3004,2854,579,352,262,284
VYS,6,2011,3881,2168,1713,327,52,47,216
VYS,6,2011,4552,2300,2252,479,170,144,318
VYS,6,2011,2006,1137,869,277,77,83,118
VYS,6,2011,6428,3421,3007,493,108,93,455
VYS,6,2011,5519,2918,2601,539,123,113,337
JHM,6,2011,4761,2408,2353,454,116,101,252
JHM,6,2011,18519,9415,9104,1689,850,1025,732
JHM,6,2011,7540,3910,3630,709,172,207,483
JHM,6,2011,6249,2917,3332,571,186,196,415
JHM,6,2011,10967,5016,5951,826,274,373,564
JHM,6,2011,3565,1792,1773,351,103,107,217
JHM,6,2011,6830,3420,3410,607,164,220,367
OLK,6,2011,2808,1410,1398,207,23,27,131
OLK,6,2011,11354,5737,5617,1041,472,617,624
OLK,6,2011,5521,3077,2444,457,150,91,257
OLK,6,2011,7700,3855,3845,583,251,151,363
OLK,6,2011,6976,3549,3427,556,143,198,252
ZLK,6,2011,5812,2854,2958,455,129,133,349
ZLK,6,2011,6276,3338,2938,567,80,139,288
ZLK,6,2011,7574,3579,3995,589,235,331,382
ZLK,6,2011,7894,4106,3788,751,324,288,443
MSK,6,2011,7605,3968,3637,481,102,74,376
MSK,6,2011,8889,4458,4431,988,848,498,516
MSK,6,2011,19756,9926,9830,1434,469,366,832
MSK,6,2011,7301,3603,3698,752,304,309,309
MSK,6,2011,9070,4405,4665,824,233,151,547
MSK,6,2011,20145,9826,10319,1680,886,639,992
PHA,7,2011,33084,16721,16363,4590,2175,2025,1241
STC,7,2011,2640,1367,1273,392,64,66,158
STC,7,2011,3100,1667,1433,374,60,28,126
STC,7,2011,8067,4155,3912,778,50,58,420
STC,7,2011,4914,2587,2327,523,178,207,79
STC,7,2011,3407,1868,1539,387,84,129,97
STC,7,2011,4859,2623,2236,537,88,70,286
STC,7,2011,3584,2003,1581,400,120,112,117
STC,7,2011,4765,2537,2228,455,230,233,227
STC,7,2011,3152,1609,1543,477,527,561,208
STC,7,2011,2684,1425,1259,426,52,71,149
STC,7,2011,5666,2860,2806,730,110,108,282
STC,7,2011,2452,1362,1090,267,29,22,139
JHC,7,2011,6006,3234,2772,867,229,150,526
JHC,7,2011,3009,1496,1513,347,103,109,156
JHC,7,2011,3084,1814,1270,470,67,65,181
JHC,7,2011,2335,1334,1001,420,101,65,138
JHC,7,2011,1592,821,771,246,75,61,102
JHC,7,2011,3136,1688,1448,352,63,54,148
JHC,7,2011,4866,2644,2222,502,131,123,250
PLK,7,2011,2476,1322,1154,278,82,64,99
PLK,7,2011,3633,1934,1699,481,111,80,208
PLK,7,2011,7081,3801,3280,1002,277,254,255
PLK,7,2011,1867,999,868,218,69,51,103
PLK,7,2011,2647,1458,1189,332,37,56,140
PLK,7,2011,1536,880,656,211,62,17,79
PLK,7,2011,3171,1594,1577,298,47,48,146
KVK,7,2011,4529,2158,2371,517,141,66,186
KVK,7,2011,6674,3158,3516,720,174,142,285
KVK,7,2011,6140,3051,3089,561,57,51,314
ULK,7,2011,9383,4710,4673,831,97,85,411
ULK,7,2011,8577,4451,4126,799,142,170,384
ULK,7,2011,5951,3182,2769,790,110,123,260
ULK,7,2011,5710,2887,2823,716,56,61,301
ULK,7,2011,9354,4905,4449,934,125,86,413
ULK,7,2011,8294,4333,3961,744,109,85,363
ULK,7,2011,8938,4212,4726,889,114,87,348
LBK,7,2011,6300,3553,2747,670,114,139,274
LBK,7,2011,4454,2361,2093,493,62,55,260
LBK,7,2011,8942,4610,4332,966,275,289,400
LBK,7,2011,3471,1824,1647,384,71,64,151
HKK,7,2011,5753,2976,2777,774,434,363,430
HKK,7,2011,2853,1561,1292,401,59,51,170
HKK,7,2011,4171,2161,2010,634,188,195,199
HKK,7,2011,2366,1393,973,393,88,177,121
HKK,7,2011,5323,2740,2583,609,132,128,243
PAK,7,2011,4553,2486,2067,618,118,82,267
PAK,7,2011,5656,3014,2642,824,295,193,318
PAK,7,2011,5423,2740,2683,572,109,128,316
PAK,7,2011,5994,3181,2813,810,244,166,338
VYS,7,2011,4008,2293,1715,510,64,36,246
VYS,7,2011,4704,2454,2250,614,178,172,328
VYS,7,2011,2105,1242,863,381,55,32,128
VYS,7,2011,6695,3656,3039,758,104,59,470
VYS,7,2011,5676,3119,2557,672,89,78,348
JHM,7,2011,4787,2486,2301,502,67,70,264
JHM,7,2011,18984,9829,9155,2075,704,548,761
JHM,7,2011,7741,4100,3641,1101,166,119,512
JHM,7,2011,6138,2960,3178,681,121,117,421
JHM,7,2011,10956,5165,5791,979,229,304,582
JHM,7,2011,3776,1967,1809,575,65,72,203
JHM,7,2011,6757,3504,3253,777,99,97,351
OLK,7,2011,2746,1405,1341,365,39,20,148
OLK,7,2011,11581,5978,5603,1232,370,516,684
OLK,7,2011,5564,3129,2435,588,141,144,278
OLK,7,2011,7761,3951,3810,713,142,154,368
OLK,7,2011,7074,3665,3409,731,205,138,297
ZLK,7,2011,5895,2965,2930,608,119,114,372
ZLK,7,2011,6406,3496,2910,777,90,70,329
ZLK,7,2011,7595,3686,3909,678,240,192,405
ZLK,7,2011,8038,4328,3710,977,197,250,482
MSK,7,2011,7561,4008,3553,610,57,75,363
MSK,7,2011,8930,4554,4376,1192,385,525,541
MSK,7,2011,19688,10046,9642,1577,211,444,879
MSK,7,2011,7401,3747,3654,841,144,197,358
MSK,7,2011,9098,4563,4535,976,196,165,554
MSK,7,2011,20297,10116,10181,1910,604,553,978
PHA,8,2011,33406,17019,16387,4531,2601,2131,1378
STC,8,2011,2683,1412,1271,459,105,71,203
STC,8,2011,3126,1727,1399,396,207,57,142
STC,8,2011,8017,4167,3850,762,96,75,467
STC,8,2011,4895,2615,2280,561,219,207,77
STC,8,2011,3459,1908,1551,424,109,105,106
STC,8,2011,4780,2573,2207,497,100,64,321
STC,8,2011,3667,2051,1616,491,131,131,161
STC,8,2011,4743,2508,2235,476,221,145,218
STC,8,2011,3007,1585,1422,485,217,246,200
STC,8,2011,2647,1401,1246,360,54,66,163
STC,8,2011,5597,2812,2785,566,141,120,332
STC,8,2011,2378,1327,1051,223,40,27,151
JHC,8,2011,5876,3191,2685,773,308,242,536
JHC,8,2011,2991,1532,1459,399,88,65,164
JHC,8,2011,2973,1777,1196,372,80,75,196
JHC,8,2011,2235,1281,954,336,141,91,163
JHC,8,2011,1540,813,727,227,102,40,111
JHC,8,2011,3158,1699,1459,368,86,81,161
JHC,8,2011,4727,2583,2144,438,189,140,285
PLK,8,2011,2408,1314,1094,279,94,76,111
PLK,8,2011,3520,1889,1631,382,120,100,228
PLK,8,2011,6998,3822,3176,826,434,422,301
PLK,8,2011,1854,1014,840,228,58,26,124
PLK,8,2011,2560,1433,1127,322,72,78,154
PLK,8,2011,1592,920,672,244,43,69,105
PLK,8,2011,3109,1578,1531,294,67,76,164
KVK,8,2011,4358,2100,2258,448,374,209,181
KVK,8,2011,6630,3167,3463,693,174,160,321
KVK,8,2011,6056,3012,3044,548,122,65,367
ULK,8,2011,9217,4664,4553,753,121,79,438
ULK,8,2011,8614,4487,4127,827,127,102,422
ULK,8,2011,5904,3188,2716,666,165,136,285
ULK,8,2011,5512,2791,2721,505,72,64,336
ULK,8,2011,9376,4947,4429,859,211,118,472
ULK,8,2011,8311,4337,3974,781,101,103,422
ULK,8,2011,8830,4221,4609,708,125,115,353
LBK,8,2011,6242,3566,2676,644,161,172,331
LBK,8,2011,4434,2363,2071,529,96,89,305
LBK,8,2011,8882,4609,4273,1110,371,319,440
LBK,8,2011,3495,1868,1627,380,71,91,190
HKK,8,2011,5835,3040,2795,792,594,552,504
HKK,8,2011,2783,1556,1227,310,125,74,181
HKK,8,2011,4059,2138,1921,482,129,107,231
HKK,8,2011,2293,1383,910,340,89,202,141
HKK,8,2011,5279,2737,2542,562,220,212,286
PAK,8,2011,4464,2444,2020,514,123,191,286
PAK,8,2011,5652,3055,2597,879,335,221,389
PAK,8,2011,5384,2755,2629,508,225,147,381
PAK,8,2011,5933,3173,2760,605,237,133,370
VYS,8,2011,4029,2310,1719,438,59,77,311
VYS,8,2011,4645,2449,2196,472,263,334,366
VYS,8,2011,2136,1263,873,364,40,51,156
VYS,8,2011,6608,3658,2950,604,74,108,533
VYS,8,2011,5622,3106,2516,540,130,115,411
JHM,8,2011,4696,2475,2221,507,99,134,317
JHM,8,2011,19070,9931,9139,1933,920,935,849
JHM,8,2011,7733,4177,3556,994,197,210,672
JHM,8,2011,6047,2942,3105,662,197,212,512
JHM,8,2011,10868,5188,5680,1027,293,231,699
JHM,8,2011,3802,1994,1808,460,90,76,257
JHM,8,2011,6537,3439,3098,754,301,240,418
OLK,8,2011,2599,1348,1251,217,21,44,143
OLK,8,2011,11365,5918,5447,1160,558,524,795
OLK,8,2011,5436,3105,2331,560,95,103,332
OLK,8,2011,7631,3937,3694,620,158,196,395
OLK,8,2011,7058,3710,3348,684,131,178,364
ZLK,8,2011,5823,2947,2876,540,129,140,442
ZLK,8,2011,6393,3534,2859,708,108,123,381
ZLK,8,2011,7481,3633,3848,693,284,250,508
ZLK,8,2011,8125,4429,3696,921,249,234,605
MSK,8,2011,7456,4011,3445,607,95,99,380
MSK,8,2011,8810,4550,4260,1089,420,450,610
MSK,8,2011,19506,10007,9499,1586,518,278,982
MSK,8,2011,7263,3718,3545,809,238,239,449
MSK,8,2011,9070,4628,4442,903,196,242,627
MSK,8,2011,20237,10102,10135,1829,769,753,1095
PHA,9,2011,32904,16674,16230,5467,2325,2298,1635
STC,9,2011,2629,1366,1263,585,75,75,278
STC,9,2011,3174,1733,1441,541,75,75,167
STC,9,2011,7916,4091,3825,999,80,86,574
STC,9,2011,4874,2554,2320,766,135,136,204
STC,9,2011,3378,1842,1536,499,64,100,123
STC,9,2011,4729,2522,2207,701,102,90,434
STC,9,2011,3622,2005,1617,639,168,171,250
STC,9,2011,4694,2444,2250,717,137,163,219
STC,9,2011,2946,1537,1409,686,102,108,274
STC,9,2011,2622,1368,1254,528,71,68,227
STC,9,2011,5518,2730,2788,786,110,146,411
STC,9,2011,2410,1305,1105,391,37,38,211
JHC,9,2011,5705,3057,2648,1106,255,354,603
JHC,9,2011,2917,1508,1409,472,77,97,186
JHC,9,2011,2892,1712,1180,552,74,97,266
JHC,9,2011,2237,1262,975,510,53,144,233
JHC,9,2011,1445,747,698,290,90,139,134
JHC,9,2011,3053,1617,1436,451,83,91,209
JHC,9,2011,4561,2470,2091,654,192,216,332
PLK,9,2011,2422,1301,1121,392,60,85,168
PLK,9,2011,3417,1800,1617,566,91,162,281
PLK,9,2011,6696,3601,3095,1091,582,375,347
PLK,9,2011,1830,995,835,351,87,67,168
PLK,9,2011,2598,1451,1147,523,26,48,230
PLK,9,2011,1539,884,655,255,51,53,121
PLK,9,2011,3072,1588,1484,397,78,65,202
KVK,9,2011,4292,2031,2261,749,180,282,217
KVK,9,2011,6596,3109,3487,846,193,198,445
KVK,9,2011,6179,3057,3122,850,49,117,532
ULK,9,2011,9162,4597,4565,1112,124,171,569
ULK,9,2011,8702,4544,4158,1264,107,156,530
ULK,9,2011,5938,3129,2809,943,125,166,404
ULK,9,2011,5511,2755,2756,776,54,69,422
ULK,9,2011,9285,4868,4417,994,76,146,557
ULK,9,2011,8280,4291,3989,1079,136,165,545
ULK,9,2011,8804,4196,4608,954,105,147,452
LBK,9,2011,6236,3524,2712,915,131,130,490
LBK,9,2011,4400,2309,2091,697,86,84,335
LBK,9,2011,8670,4459,4211,1310,402,403,508
LBK,9,2011,3470,1852,1618,511,71,89,268
HKK,9,2011,5782,2963,2819,1028,553,568,628
HKK,9,2011,2729,1497,1232,471,77,89,250
HKK,9,2011,3928,2014,1914,682,116,185,322
HKK,9,2011,2147,1290,857,447,89,95,171
HKK,9,2011,5213,2696,2517,860,178,132,412
PAK,9,2011,4395,2385,2010,750,162,148,404
PAK,9,2011,5425,2880,2545,1057,566,597,520
PAK,9,2011,5294,2683,2611,735,181,99,505
PAK,9,2011,5803,3085,2718,898,242,277,475
VYS,9,2011,3889,2189,1700,584,125,58,362
VYS,9,2011,4552,2270,2282,819,261,188,500
VYS,9,2011,2075,1174,901,444,58,56,184
VYS,9,2011,6549,3609,2940,840,101,78,664
VYS,9,2011,5354,2866,2488,719,130,124,541
JHM,9,2011,4611,2399,2212,702,114,131,416
JHM,9,2011,18724,9673,9051,2316,805,880,922
JHM,9,2011,7712,4132,3580,1313,196,176,831
JHM,9,2011,5957,2884,3073,883,146,119,619
JHM,9,2011,10669,5078,5591,1267,267,290,847
JHM,9,2011,3863,2001,1862,707,55,78,389
JHM,9,2011,6275,3302,2973,918,143,123,583
OLK,9,2011,2615,1349,1266,398,32,28,203
OLK,9,2011,11388,5933,5455,1796,484,590,1029
OLK,9,2011,5335,3028,2307,776,125,82,419
OLK,9,2011,7541,3880,3661,930,165,187,546
OLK,9,2011,7067,3697,3370,997,134,165,494
ZLK,9,2011,5777,2883,2894,835,111,137,522
ZLK,9,2011,6361,3462,2899,991,128,100,449
ZLK,9,2011,7404,3570,3834,1007,306,348,669
ZLK,9,2011,7842,4220,3622,1129,233,229,781
MSK,9,2011,7528,4047,3481,894,61,109,505
MSK,9,2011,8545,4394,4151,1403,398,574,700
MSK,9,2011,19309,9831,9478,2130,338,470,1149
MSK,9,2011,7050,3587,3463,1085,213,161,550
MSK,9,2011,8980,4576,4404,1204,205,186,746
MSK,9,2011,20102,10006,10096,2527,922,775,1245
PHA,10,2011,32786,16531,16255,4583,2366,1993,1751
STC,10,2011,2634,1387,1247,420,60,88,298
STC,10,2011,3086,1690,1396,350,74,107,193
STC,10,2011,7878,4049,3829,836,139,156,560
STC,10,2011,4803,2499,2304,548,188,176,259
STC,10,2011,3370,1822,1548,376,52,113,129
STC,10,2011,4672,2480,2192,551,63,88,441
STC,10,2011,3526,1960,1566,461,158,162,254
STC,10,2011,4613,2388,2225,429,156,127,291
STC,10,2011,2894,1511,1383,519,134,113,264
STC,10,2011,2627,1353,1274,408,49,68,241
STC,10,2011,5422,2669,2753,539,155,163,399
STC,10,2011,2375,1294,1081,253,16,36,219
JHC,10,2011,5694,3045,2649,915,305,233,617
JHC,10,2011,2924,1516,1408,368,107,97,212
JHC,10,2011,2989,1792,1197,481,69,73,295
JHC,10,2011,2260,1277,983,373,64,103,213
JHC,10,2011,1436,751,685,260,49,101,135
JHC,10,2011,3060,1620,1440,333,76,58,216
JHC,10,2011,4517,2445,2072,469,168,263,357
PLK,10,2011,2379,1274,1105,283,112,92,167
PLK,10,2011,3419,1788,1631,493,116,97,275
PLK,10,2011,6582,3488,3094,880,514,546,332
PLK,10,2011,1831,986,845,250,238,214,159
PLK,10,2011,2534,1401,1133,320,41,38,260
PLK,10,2011,1522,866,656,242,36,82,113
PLK,10,2011,2992,1516,1476,286,48,112,187
KVK,10,2011,4168,1977,2191,517,140,158,228
KVK,10,2011,6597,3108,3489,670,142,226,459
KVK,10,2011,6092,3012,3080,600,85,58,529
ULK,10,2011,8977,4536,4441,826,69,95,563
ULK,10,2011,8776,4625,4151,936,105,108,540
ULK,10,2011,5947,3164,2783,779,138,163,400
ULK,10,2011,5611,2770,2841,769,54,77,424
ULK,10,2011,9161,4755,4406,825,101,126,543
ULK,10,2011,8182,4243,3939,688,128,108,535
ULK,10,2011,8781,4178,4603,691,165,109,519
LBK,10,2011,6212,3514,2698,726,145,116,487
LBK,10,2011,4288,2268,2020,475,109,74,335
LBK,10,2011,8484,4353,4131,944,344,309,502
LBK,10,2011,3426,1810,1616,382,124,67,296
HKK,10,2011,5720,2931,2789,718,453,559,631
HKK,10,2011,2768,1516,1252,394,80,111,257
HKK,10,2011,3850,1960,1890,520,119,124,313
HKK,10,2011,2092,1234,858,328,75,120,168
HKK,10,2011,5327,2741,2586,710,143,164,430
PAK,10,2011,4314,2326,1988,513,151,150,404
PAK,10,2011,5347,2831,2516,847,374,452,506
PAK,10,2011,5289,2693,2596,583,114,97,496
PAK,10,2011,5720,3017,2703,620,205,263,465
VYS,10,2011,3768,2128,1640,376,66,70,334
VYS,10,2011,4698,2323,2375,661,178,182,529
VYS,10,2011,1995,1118,877,268,70,92,187
VYS,10,2011,6487,3589,2898,611,85,118,633
VYS,10,2011,5295,2843,2452,551,106,136,545
JHM,10,2011,4580,2375,2205,483,148,139,422
JHM,10,2011,18383,9471,8912,1675,741,776,981
JHM,10,2011,7606,4064,3542,844,429,264,807
JHM,10,2011,5846,2827,3019,613,172,179,601
JHM,10,2011,10503,4940,5563,900,164,198,848
JHM,10,2011,3837,1982,1855,446,59,74,381
JHM,10,2011,6332,3373,2959,768,170,160,609
OLK,10,2011,2633,1357,1276,301,17,20,197
OLK,10,2011,11159,5821,5338,1080,417,393,1061
OLK,10,2011,5358,3057,2301,574,75,102,426
OLK,10,2011,7506,3843,3663,614,191,182,555
OLK,10,2011,7084,3703,3381,711,112,139,501
ZLK,10,2011,5705,2823,2882,519,101,112,541
ZLK,10,2011,6175,3350,2825,617,89,166,459
ZLK,10,2011,7339,3561,3778,712,208,230,639
ZLK,10,2011,7713,4157,3556,843,202,237,737
MSK,10,2011,7613,4046,3567,720,83,95,517
MSK,10,2011,8514,4338,4176,1119,339,423,664
MSK,10,2011,18994,9717,9277,1598,205,454,1100
MSK,10,2011,6954,3520,3434,871,132,210,542
MSK,10,2011,8808,4465,4343,872,177,178,727
MSK,10,2011,19779,9850,9929,1827,567,820,1257
PHA,11,2011,32698,16391,16307,4324,1830,1857,1715
STC,11,2011,2674,1393,1281,432,58,55,281
STC,11,2011,3052,1672,1380,346,52,84,184
STC,11,2011,7880,4041,3839,790,97,103,532
STC,11,2011,4827,2467,2360,603,141,139,255
STC,11,2011,3519,1876,1643,492,73,71,132
STC,11,2011,4697,2491,2206,469,52,55,426
STC,11,2011,3417,1915,1502,446,136,116,216
STC,11,2011,4645,2367,2278,561,465,306,283
STC,11,2011,2919,1497,1422,491,83,79,249
STC,11,2011,2602,1340,1262,364,34,83,226
STC,11,2011,5611,2711,2900,678,98,117,388
STC,11,2011,2405,1308,1097,249,10,12,206
JHC,11,2011,5780,3007,2773,884,229,238,577
JHC,11,2011,3083,1566,1517,498,70,138,184
JHC,11,2011,3148,1853,1295,556,76,64,291
JHC,11,2011,2417,1358,1059,461,62,59,194
JHC,11,2011,1537,781,756,360,54,58,132
JHC,11,2011,3051,1584,1467,307,46,81,206
JHC,11,2011,4634,2475,2159,538,145,137,337
PLK,11,2011,2362,1256,1106,275,53,94,147
PLK,11,2011,3629,1924,1705,616,106,160,255
PLK,11,2011,6373,3366,3007,685,487,606,298
PLK,11,2011,1855,996,859,261,35,35,150
PLK,11,2011,2555,1378,1177,366,34,60,233
PLK,11,2011,1502,844,658,211,32,29,105
PLK,11,2011,2993,1516,1477,328,61,67,169
KVK,11,2011,4215,2063,2152,641,134,154,217
KVK,11,2011,6529,3096,3433,695,140,130,418
KVK,11,2011,6018,2990,3028,543,25,49,477
ULK,11,2011,9074,4586,4488,891,74,84,568
ULK,11,2011,8798,4612,4186,822,131,178,511
ULK,11,2011,6066,3175,2891,720,116,167,389
ULK,11,2011,5625,2766,2859,603,41,32,399
ULK,11,2011,9134,4751,4383,747,69,142,523
ULK,11,2011,8201,4237,3964,740,150,157,500
ULK,11,2011,8870,4185,4685,693,121,119,514
LBK,11,2011,6238,3516,2722,676,113,129,450
LBK,11,2011,4298,2236,2062,455,131,131,319
LBK,11,2011,8504,4355,4149,992,392,438,466
LBK,11,2011,3469,1786,1683,395,119,154,272
HKK,11,2011,5814,2956,2858,706,397,462,614
HKK,11,2011,2866,1512,1354,427,77,82,227
HKK,11,2011,3964,1976,1988,578,115,171,289
HKK,11,2011,2146,1253,893,362,84,105,154
HKK,11,2011,5504,2795,2709,703,173,175,417
PAK,11,2011,4436,2350,2086,630,109,159,390
PAK,11,2011,5496,2878,2618,867,229,304,491
PAK,11,2011,5384,2698,2686,618,123,80,457
PAK,11,2011,5744,2975,2769,645,198,343,423
VYS,11,2011,3823,2112,1711,521,52,108,321
VYS,11,2011,4817,2347,2470,654,204,260,520
VYS,11,2011,2022,1095,927,368,50,67,169
VYS,11,2011,6809,3663,3146,805,44,105,628
VYS,11,2011,5391,2847,2544,558,71,125,518
JHM,11,2011,4704,2431,2273,527,87,73,421
JHM,11,2011,18329,9411,8918,1707,725,790,963
JHM,11,2011,7569,3998,3571,855,137,203,740
JHM,11,2011,6126,2926,3200,852,120,126,579
JHM,11,2011,10711,4950,5761,1006,180,210,846
JHM,11,2011,3923,1980,1943,444,60,81,359
JHM,11,2011,6960,3647,3313,1267,235,254,578
OLK,11,2011,2924,1471,1453,526,43,49,205
OLK,11,2011,11411,5912,5499,1354,369,418,1031
OLK,11,2011,5353,3041,2312,552,97,100,401
OLK,11,2011,7596,3876,3720,692,78,95,531
OLK,11,2011,7277,3725,3552,830,108,118,472
ZLK,11,2011,5807,2830,2977,626,104,106,521
ZLK,11,2011,6271,3355,2916,706,106,111,436
ZLK,11,2011,7450,3561,3889,832,154,237,623
ZLK,11,2011,7839,4186,3653,997,180,165,701
MSK,11,2011,7867,4142,3725,791,45,59,492
MSK,11,2011,8680,4348,4332,1186,297,413,587
MSK,11,2011,18808,9536,9272,1611,318,262,1020
MSK,11,2011,6988,3440,3548,881,207,286,493
MSK,11,2011,8807,4372,4435,835,144,215,690
MSK,11,2011,19884,9852,10032,1932,522,633,1213
PHA,12,2011,32580,16326,16254,3801,1967,1722,1622
STC,12,2011,2933,1441,1492,595,61,42,248
STC,12,2011,3201,1712,1489,450,39,33,180
STC,12,2011,8020,4080,3940,764,94,111,509
STC,12,2011,5160,2560,2600,733,64,95,254
STC,12,2011,3723,1919,1804,518,57,41,121
STC,12,2011,4860,2538,2322,523,28,51,417
STC,12,2011,3499,1943,1556,439,101,139,194
STC,12,2011,4910,2443,2467,633,110,156,287
STC,12,2011,2957,1490,1467,424,100,205,230
STC,12,2011,2568,1317,1251,318,36,110,198
STC,12,2011,6147,2805,3342,944,104,106,372
STC,12,2011,2616,1358,1258,367,17,31,205
JHC,12,2011,6167,3055,3112,1018,162,206,572
JHC,12,2011,3482,1629,1853,625,35,40,192
JHC,12,2011,3715,1949,1766,868,37,33,294
JHC,12,2011,2728,1442,1286,637,39,52,189
JHC,12,2011,1906,846,1060,550,30,39,130
JHC,12,2011,3408,1639,1769,573,43,39,202
JHC,12,2011,5044,2574,2470,743,109,145,331
PLK,12,2011,2609,1283,1326,453,69,43,141
PLK,12,2011,4067,1953,2114,793,160,42,253
PLK,12,2011,6837,3519,3318,1169,627,330,294
PLK,12,2011,2006,1027,979,353,10,44,152
PLK,12,2011,2847,1451,1396,512,25,28,233
PLK,12,2011,1620,902,718,266,12,18,98
PLK,12,2011,3322,1575,1747,557,49,43,160
KVK,12,2011,4509,2163,2346,756,64,108,211
KVK,12,2011,6658,3141,3517,781,112,109,395
KVK,12,2011,6280,3092,3188,766,24,34,465
ULK,12,2011,9486,4691,4795,988,40,50,577
ULK,12,2011,9029,4688,4341,850,61,66,509
ULK,12,2011,6523,3279,3244,871,63,372,395
ULK,12,2011,6044,2872,3172,800,45,37,408
ULK,12,2011,9402,4855,4547,778,35,66,517
ULK,12,2011,8514,4357,4157,799,33,57,479
ULK,12,2011,9089,4223,4866,656,79,98,516
LBK,12,2011,6519,3613,2906,784,45,112,429
LBK,12,2011,4381,2197,2184,478,172,105,307
LBK,12,2011,8727,4421,4306,928,221,270,452
LBK,12,2011,3659,1778,1881,527,36,58,268
HKK,12,2011,6450,3071,3379,1125,598,513,626
HKK,12,2011,3179,1553,1626,563,58,83,222
HKK,12,2011,4356,2060,2296,751,45,88,298
HKK,12,2011,2369,1280,1089,467,34,70,146
HKK,12,2011,5831,2767,3064,885,127,166,415
PAK,12,2011,5294,2469,2825,1202,142,142,409
PAK,12,2011,5921,2975,2946,1010,142,321,478
PAK,12,2011,6090,2814,3276,1054,54,40,467
PAK,12,2011,6326,3059,3267,1015,71,120,423
VYS,12,2011,4302,2188,2114,790,37,51,321
VYS,12,2011,5272,2365,2907,863,116,190,516
VYS,12,2011,2398,1155,1243,587,61,67,177
VYS,12,2011,7631,3791,3840,1223,28,55,640
VYS,12,2011,6002,2945,3057,964,51,113,531
JHM,12,2011,4965,2473,2492,676,69,78,397
JHM,12,2011,18590,9432,9158,1624,425,489,931
JHM,12,2011,7998,4054,3944,992,132,49,734
JHM,12,2011,6892,3109,3783,1115,64,64,578
JHM,12,2011,11874,5241,6633,1669,67,127,869
JHM,12,2011,4225,1996,2229,606,57,55,363
JHM,12,2011,8178,3999,4179,1615,92,110,589
OLK,12,2011,3444,1549,1895,770,13,14,211
OLK,12,2011,12470,6052,6418,1891,274,499,1010
OLK,12,2011,5844,3149,2695,928,53,71,417
OLK,12,2011,8346,4010,4336,1168,53,51,531
OLK,12,2011,8015,3859,4156,1203,56,86,488
ZLK,12,2011,6181,2894,3287,751,70,65,518
ZLK,12,2011,6741,3413,3328,957,73,72,422
ZLK,12,2011,8135,3672,4463,1190,204,167,635
ZLK,12,2011,8361,4318,4043,1152,106,94,705
MSK,12,2011,8750,4339,4411,1299,78,57,493
MSK,12,2011,9264,4457,4807,1393,157,261,566
MSK,12,2011,19218,9614,9604,1709,181,160,999
MSK,12,2011,7534,3521,4013,1153,250,107,480
MSK,12,2011,9808,4531,5277,1527,92,112,701
MSK,12,2011,20445,9981,10464,1973,289,389,1196
PHA,1,2012,33323,16521,16802,5278,1707,2310,1458
STC,1,2012,3141,1527,1614,580,90,101,222
STC,1,2012,3346,1747,1599,534,66,112,165
STC,1,2012,8422,4248,4174,1142,83,82,470
STC,1,2012,5357,2604,2753,724,101,144,235
STC,1,2012,4094,2019,2075,674,83,94,121
STC,1,2012,5043,2582,2461,698,86,54,374
STC,1,2012,3709,2014,1695,651,161,106,174
STC,1,2012,5012,2468,2544,615,95,239,247
STC,1,2012,3070,1500,1570,659,162,398,197
STC,1,2012,2734,1399,1335,562,38,25,171
STC,1,2012,6583,2916,3667,974,109,103,335
STC,1,2012,2818,1438,1380,427,13,11,201
JHC,1,2012,6673,3186,3487,1408,205,261,649
JHC,1,2012,3879,1722,2157,763,68,49,169
JHC,1,2012,4106,2027,2079,770,84,75,258
JHC,1,2012,3048,1541,1507,624,43,70,186
JHC,1,2012,2149,848,1301,542,48,50,110
JHC,1,2012,3746,1707,2039,600,77,78,186
JHC,1,2012,5441,2697,2744,859,213,130,327
PLK,1,2012,2847,1372,1475,519,44,83,118
PLK,1,2012,4363,1981,2382,751,92,79,216
PLK,1,2012,6866,3482,3384,1038,452,664,274
PLK,1,2012,2117,1039,1078,351,43,15,138
PLK,1,2012,3022,1512,1510,530,46,37,203
PLK,1,2012,1684,914,770,270,82,48,91
PLK,1,2012,3558,1619,1939,567,92,49,137
KVK,1,2012,4853,2279,2574,844,186,163,218
KVK,1,2012,6969,3265,3704,962,158,122,379
KVK,1,2012,6535,3174,3361,804,63,79,452
ULK,1,2012,10091,4825,5266,1303,98,72,553
ULK,1,2012,9388,4863,4525,1040,103,96,499
ULK,1,2012,6916,3381,3535,935,75,67,379
ULK,1,2012,6373,3054,3319,845,51,27,393
ULK,1,2012,9853,5054,4799,1083,86,56,495
ULK,1,2012,9004,4561,4443,1050,138,116,446
ULK,1,2012,9271,4296,4975,855,99,266,473
LBK,1,2012,6771,3643,3128,857,86,73,389
LBK,1,2012,4392,2157,2235,563,93,222,241
LBK,1,2012,9091,4550,4541,1341,412,351,414
LBK,1,2012,3829,1814,2015,584,60,80,225
HKK,1,2012,6875,3225,3650,1096,696,529,580
HKK,1,2012,3372,1580,1792,584,76,69,198
HKK,1,2012,4587,2091,2496,745,136,116,270
HKK,1,2012,2613,1343,1270,528,77,50,136
HKK,1,2012,6141,2890,3251,947,129,182,376
PAK,1,2012,5666,2496,3170,865,117,134,371
PAK,1,2012,6251,3050,3201,1128,287,322,417
PAK,1,2012,6582,2934,3648,995,137,341,435
PAK,1,2012,6696,3148,3548,985,152,127,428
VYS,1,2012,4525,2203,2322,639,43,52,271
VYS,1,2012,5626,2452,3174,874,143,153,480
VYS,1,2012,2615,1221,1394,522,42,51,155
VYS,1,2012,7929,3806,4123,895,51,28,599
VYS,1,2012,6360,2998,3362,844,118,59,479
JHM,1,2012,5223,2564,2659,720,81,126,372
JHM,1,2012,18774,9432,9342,2117,752,615,1068
JHM,1,2012,8317,4067,4250,1188,113,109,657
JHM,1,2012,7264,3169,4095,987,77,99,522
JHM,1,2012,12534,5264,7270,1535,156,127,819
JHM,1,2012,4459,2039,2420,612,44,56,329
JHM,1,2012,9071,4175,4896,1589,104,168,569
OLK,1,2012,3757,1590,2167,637,7,14,174
OLK,1,2012,13159,6234,6925,1756,587,353,927
OLK,1,2012,6122,3207,2915,785,76,88,407
OLK,1,2012,8918,4116,4802,1197,127,114,475
OLK,1,2012,8405,3925,4480,989,131,80,474
ZLK,1,2012,6398,2939,3459,792,102,106,485
ZLK,1,2012,7066,3464,3602,951,89,89,371
ZLK,1,2012,8454,3709,4745,1075,251,279,542
ZLK,1,2012,8753,4358,4395,1248,162,318,619
MSK,1,2012,9159,4368,4791,1060,80,72,460
MSK,1,2012,9876,4648,5228,1596,394,250,538
MSK,1,2012,19850,9824,10026,2214,229,478,922
MSK,1,2012,7801,3535,4266,1084,210,266,465
MSK,1,2012,10286,4636,5650,1295,100,137,624
MSK,1,2012,21118,10126,10992,2461,472,538,1478
PHA,2,2012,34101,16781,17320,4591,2309,1131,1476
STC,2,2012,3272,1536,1736,520,78,91,219
STC,2,2012,3387,1762,1625,396,100,43,161
STC,2,2012,8578,4281,4297,848,89,77,460
STC,2,2012,5459,2666,2793,601,80,116,238
STC,2,2012,4221,2083,2138,449,224,179,116
STC,2,2012,5130,2633,2497,552,51,50,360
STC,2,2012,3697,1964,1733,418,106,154,169
STC,2,2012,5021,2456,2565,476,227,181,236
STC,2,2012,3130,1519,1611,521,353,56,186
STC,2,2012,2822,1428,1394,392,75,39,152
STC,2,2012,6639,2914,3725,612,121,130,314
STC,2,2012,2901,1464,1437,274,90,42,205
JHC,2,2012,6864,3268,3596,986,266,198,794
JHC,2,2012,3916,1732,2184,382,81,83,162
JHC,2,2012,4156,2070,2086,445,42,68,227
JHC,2,2012,3047,1514,1533,327,51,35,190
JHC,2,2012,2217,895,1322,323,47,31,113
JHC,2,2012,3714,1679,2035,295,87,88,166
JHC,2,2012,5482,2723,2759,491,131,126,331
PLK,2,2012,2858,1393,1465,297,53,75,106
PLK,2,2012,4293,1952,2341,418,88,169,184
PLK,2,2012,6859,3500,3359,935,457,477,263
PLK,2,2012,2089,1029,1060,233,41,63,130
PLK,2,2012,3031,1492,1539,350,48,40,185
PLK,2,2012,1685,898,787,193,44,49,91
PLK,2,2012,3529,1597,1932,345,22,35,131
KVK,2,2012,4867,2273,2594,548,131,159,221
KVK,2,2012,7112,3272,3840,662,168,145,379
KVK,2,2012,6616,3200,3416,565,33,36,446
ULK,2,2012,10302,4882,5420,810,155,75,564
ULK,2,2012,9632,4954,4678,882,150,109,471
ULK,2,2012,7092,3408,3684,705,88,80,366
ULK,2,2012,6371,3051,3320,498,64,47,377
ULK,2,2012,10115,5167,4948,828,199,256,503
ULK,2,2012,9186,4608,4578,771,76,100,399
ULK,2,2012,9688,4434,5254,1066,128,91,451
LBK,2,2012,6893,3651,3242,653,156,87,367
LBK,2,2012,4445,2160,2285,449,105,86,221
LBK,2,2012,9216,4540,4676,1029,334,296,373
LBK,2,2012,3873,1843,2030,330,80,64,201
HKK,2,2012,7027,3292,3735,772,478,577,574
HKK,2,2012,3386,1576,1810,341,55,42,202
HKK,2,2012,4679,2109,2570,555,84,83,270
HKK,2,2012,2668,1378,1290,322,43,54,140
HKK,2,2012,6214,2887,3327,616,192,154,353
PAK,2,2012,5735,2535,3200,594,123,90,350
PAK,2,2012,6339,3086,3253,880,190,159,377
PAK,2,2012,6575,2909,3666,464,80,124,424
PAK,2,2012,6699,3141,3558,622,210,361,421
VYS,2,2012,4549,2231,2318,425,53,52,262
VYS,2,2012,5716,2446,3270,569,141,133,482
VYS,2,2012,2566,1208,1358,286,67,60,130
VYS,2,2012,8020,3827,4193,611,40,58,600
VYS,2,2012,6424,3021,3403,553,67,74,444
JHM,2,2012,5245,2547,2698,510,102,65,366
JHM,2,2012,19064,9515,9549,1957,845,648,1356
JHM,2,2012,8379,4068,4311,890,102,90,608
JHM,2,2012,7310,3160,4150,642,150,78,506
JHM,2,2012,12639,5305,7334,1045,154,119,799
JHM,2,2012,4457,2014,2443,422,54,49,300
JHM,2,2012,9107,4210,4897,788,155,86,548
OLK,2,2012,3760,1601,2159,288,32,22,155
OLK,2,2012,13434,6384,7050,1310,400,412,844
OLK,2,2012,6256,3247,3009,597,83,91,390
OLK,2,2012,8989,4142,4847,652,50,40,466
OLK,2,2012,8507,3916,4591,670,91,100,470
ZLK,2,2012,6530,2994,3536,622,99,105,490
ZLK,2,2012,7159,3468,3691,724,88,42,340
ZLK,2,2012,8424,3695,4729,750,223,229,496
ZLK,2,2012,8932,4391,4541,898,150,177,605
MSK,2,2012,9320,4417,4903,688,52,72,439
MSK,2,2012,10060,4671,5389,1113,301,293,529
MSK,2,2012,20069,9869,10200,1749,431,254,914
MSK,2,2012,7908,3537,4371,913,176,157,467
MSK,2,2012,10430,4664,5766,986,166,95,599
MSK,2,2012,21603,10292,11311,2231,450,503,1876
PHA,3,2012,33049,16298,16751,2529,2464,1376,1190
STC,3,2012,3138,1498,1640,296,79,65,218
STC,3,2012,3272,1682,1590,303,71,159,156
STC,3,2012,8227,4146,4081,512,147,88,443
STC,3,2012,5263,2627,2636,416,121,120,251
STC,3,2012,4046,2034,2012,277,150,82,119
STC,3,2012,5022,2567,2455,394,62,42,352
STC,3,2012,3555,1907,1648,264,160,109,177
STC,3,2012,4782,2380,2402,297,371,221,230
STC,3,2012,3198,1537,1661,493,76,96,193
STC,3,2012,2890,1453,1437,340,57,20,164
STC,3,2012,6235,2803,3432,397,119,127,346
STC,3,2012,2844,1441,1403,193,19,21,209
JHC,3,2012,6561,3214,3347,627,419,358,470
JHC,3,2012,3777,1728,2049,317,100,62,155
JHC,3,2012,3877,2017,1860,237,70,47,216
JHC,3,2012,2961,1499,1462,336,78,63,161
JHC,3,2012,2048,878,1170,150,61,53,103
JHC,3,2012,3538,1697,1841,248,83,72,163
JHC,3,2012,5297,2694,2603,360,153,202,304
PLK,3,2012,2604,1311,1293,118,114,60,98
PLK,3,2012,3965,1908,2057,284,148,94,187
PLK,3,2012,6661,3419,3242,653,597,473,366
PLK,3,2012,1967,989,978,168,55,51,137
PLK,3,2012,2840,1429,1411,244,106,34,170
PLK,3,2012,1561,827,734,114,60,49,84
PLK,3,2012,3287,1524,1763,162,35,103,160
KVK,3,2012,4546,2132,2414,369,141,92,229
KVK,3,2012,6884,3182,3702,445,205,115,367
KVK,3,2012,6569,3186,3383,509,68,45,422
ULK,3,2012,10077,4841,5236,566,132,84,544
ULK,3,2012,9621,4948,4673,809,137,134,464
ULK,3,2012,6937,3349,3588,524,107,65,362
ULK,3,2012,6263,3048,3215,485,66,39,369
ULK,3,2012,10012,5137,4875,596,143,54,485
ULK,3,2012,9163,4607,4556,622,103,98,371
ULK,3,2012,9491,4376,5115,478,84,102,425
LBK,3,2012,6825,3585,3240,523,151,122,401
LBK,3,2012,4440,2189,2251,448,115,128,240
LBK,3,2012,8979,4475,4504,830,1055,756,420
LBK,3,2012,3772,1812,1960,258,64,70,189
HKK,3,2012,6638,3227,3411,445,398,550,553
HKK,3,2012,3244,1564,1680,224,129,85,186
HKK,3,2012,4527,2069,2458,377,120,101,236
HKK,3,2012,2633,1388,1245,268,109,43,127
HKK,3,2012,5997,2821,3176,432,166,132,333
PAK,3,2012,5206,2426,2780,357,132,151,360
PAK,3,2012,6157,3077,3080,580,432,249,352
PAK,3,2012,6203,2844,3359,312,249,64,393
PAK,3,2012,6553,3105,3448,478,340,164,428
VYS,3,2012,4215,2156,2059,227,43,40,279
VYS,3,2012,5390,2403,2987,296,177,168,473
VYS,3,2012,2515,1208,1307,345,62,43,136
VYS,3,2012,7589,3784,3805,364,62,55,600
VYS,3,2012,6138,2954,3184,361,68,80,453
JHM,3,2012,5236,2580,2656,448,115,119,369
JHM,3,2012,19007,9516,9491,1592,770,740,818
JHM,3,2012,8250,4047,4203,740,165,363,604
JHM,3,2012,6874,3040,3834,431,206,176,491
JHM,3,2012,12215,5314,6901,768,156,185,745
JHM,3,2012,4278,1975,2303,336,63,37,275
JHM,3,2012,8486,4070,4416,498,143,142,500
OLK,3,2012,3632,1609,2023,214,64,27,142
OLK,3,2012,12718,6191,6527,612,494,389,845
OLK,3,2012,6057,3228,2829,466,233,87,360
OLK,3,2012,8519,4098,4421,435,105,87,445
OLK,3,2012,8323,3931,4392,530,166,98,460
ZLK,3,2012,6355,2991,3364,385,113,80,480
ZLK,3,2012,6844,3386,3458,384,117,133,330
ZLK,3,2012,8217,3680,4537,630,227,205,474
ZLK,3,2012,8897,4484,4413,823,225,183,583
MSK,3,2012,8942,4311,4631,362,57,57,408
MSK,3,2012,9901,4629,5272,921,302,270,531
MSK,3,2012,19995,9827,10168,1390,258,279,888
MSK,3,2012,7824,3559,4265,767,156,207,466
MSK,3,2012,10119,4643,5476,727,148,200,583
MSK,3,2012,21442,10137,11305,1743,507,448,1109
PHA,4,2012,33059,16238,16821,3248,1973,1528,1107
STC,4,2012,2770,1358,1412,303,105,134,177
STC,4,2012,3156,1638,1518,271,210,185,143
STC,4,2012,7968,4058,3910,537,65,105,408
STC,4,2012,5022,2560,2462,425,87,75,224
STC,4,2012,3731,1942,1789,271,167,44,96
STC,4,2012,4854,2522,2332,367,89,40,310
STC,4,2012,3491,1901,1590,345,147,127,162
STC,4,2012,4547,2315,2232,324,132,51,231
STC,4,2012,3045,1472,1573,397,159,44,176
STC,4,2012,2789,1404,1385,325,74,38,150
STC,4,2012,5710,2663,3047,394,71,94,304
STC,4,2012,2707,1393,1314,196,18,22,201
JHC,4,2012,6257,3169,3088,772,459,244,418
JHC,4,2012,3374,1611,1763,278,119,60,135
JHC,4,2012,3391,1871,1520,293,95,66,178
JHC,4,2012,2588,1382,1206,275,77,40,133
JHC,4,2012,1794,844,950,197,106,63,103
JHC,4,2012,3326,1659,1667,263,66,53,143
JHC,4,2012,4934,2602,2332,394,131,124,273
PLK,4,2012,2443,1277,1166,208,130,66,85
PLK,4,2012,3569,1777,1792,321,155,123,170
PLK,4,2012,6457,3382,3075,583,544,521,398
PLK,4,2012,1857,951,906,190,94,49,121
PLK,4,2012,2616,1368,1248,289,67,32,153
PLK,4,2012,1512,807,705,119,41,48,77
PLK,4,2012,3028,1472,1556,229,38,49,159
KVK,4,2012,4257,1992,2265,420,93,85,234
KVK,4,2012,6630,3140,3490,517,199,117,314
KVK,4,2012,6313,3094,3219,447,58,54,388
ULK,4,2012,9680,4740,4940,645,136,164,518
ULK,4,2012,9279,4851,4428,641,108,90,432
ULK,4,2012,6418,3176,3242,524,111,76,322
ULK,4,2012,5924,2969,2955,445,106,102,335
ULK,4,2012,9775,5067,4708,669,98,30,460
ULK,4,2012,8852,4426,4426,580,66,85,344
ULK,4,2012,9344,4328,5016,558,117,122,394
LBK,4,2012,6501,3446,3055,403,123,136,355
LBK,4,2012,4240,2135,2105,385,87,67,218
LBK,4,2012,8757,4430,4327,712,393,610,388
LBK,4,2012,3552,1767,1785,318,81,58,172
HKK,4,2012,6282,3142,3140,510,398,359,500
HKK,4,2012,2933,1499,1434,219,67,80,170
HKK,4,2012,4167,2006,2161,369,115,114,216
HKK,4,2012,2460,1354,1106,287,86,68,105
HKK,4,2012,5849,2857,2992,657,277,161,301
PAK,4,2012,4570,2296,2274,376,122,67,330
PAK,4,2012,5800,2976,2824,531,292,292,332
PAK,4,2012,5499,2676,2823,313,142,222,335
PAK,4,2012,6283,3117,3166,497,237,142,384
VYS,4,2012,3879,2066,1813,302,46,45,261
VYS,4,2012,5052,2421,2631,390,156,127,444
VYS,4,2012,2207,1148,1059,231,39,59,116
VYS,4,2012,6790,3572,3218,392,51,59,551
VYS,4,2012,5547,2809,2738,367,94,107,392
JHM,4,2012,4930,2469,2461,425,111,95,351
JHM,4,2012,18550,9334,9216,1521,753,936,787
JHM,4,2012,7795,3948,3847,690,105,146,551
JHM,4,2012,6180,2891,3289,427,172,148,429
JHM,4,2012,11361,5156,6205,744,130,152,657
JHM,4,2012,4015,1932,2083,327,52,53,238
JHM,4,2012,7501,3791,3710,424,136,127,446
OLK,4,2012,3300,1557,1743,254,158,65,146
OLK,4,2012,11930,5997,5933,828,389,382,797
OLK,4,2012,5664,3103,2561,395,110,132,298
OLK,4,2012,8077,4027,4050,455,86,75,438
OLK,4,2012,7753,3778,3975,578,114,115,430
ZLK,4,2012,6077,2923,3154,426,86,69,442
ZLK,4,2012,6435,3295,3140,474,93,61,287
ZLK,4,2012,7672,3583,4089,695,165,184,412
ZLK,4,2012,8336,4300,4036,702,199,139,532
MSK,4,2012,8392,4180,4212,458,98,43,368
MSK,4,2012,9218,4453,4765,896,352,327,455
MSK,4,2012,19735,9762,9973,1412,418,283,933
MSK,4,2012,7211,3391,3820,679,158,245,421
MSK,4,2012,9379,4493,4886,762,132,117,534
MSK,4,2012,20976,10073,10903,1788,635,551,1029
PHA,5,2012,33205,16377,16828,3456,2388,1793,972
STC,5,2012,2632,1348,1284,302,76,43,111
STC,5,2012,3128,1639,1489,271,106,147,138
STC,5,2012,7895,4059,3836,632,74,96,323
STC,5,2012,4930,2518,2412,423,208,100,200
STC,5,2012,3644,1951,1693,356,234,79,96
STC,5,2012,4740,2469,2271,382,94,87,278
STC,5,2012,3442,1895,1547,315,130,107,143
STC,5,2012,4415,2304,2111,355,118,118,172
STC,5,2012,2954,1466,1488,326,113,98,145
STC,5,2012,2753,1385,1368,248,98,74,127
STC,5,2012,5442,2599,2843,333,137,95,244
STC,5,2012,2664,1404,1260,182,40,29,201
JHC,5,2012,6126,3144,2982,777,328,215,461
JHC,5,2012,3142,1553,1589,266,123,91,114
JHC,5,2012,3099,1775,1324,247,63,90,172
JHC,5,2012,2451,1353,1098,219,79,65,107
JHC,5,2012,1612,801,811,154,40,28,87
JHC,5,2012,3178,1667,1511,188,86,112,154
JHC,5,2012,4651,2555,2096,334,171,177,240
PLK,5,2012,2348,1273,1075,164,119,108,77
PLK,5,2012,3272,1675,1597,228,141,53,164
PLK,5,2012,6296,3354,2942,624,533,502,205
PLK,5,2012,1766,936,830,152,89,33,99
PLK,5,2012,2497,1339,1158,246,90,114,118
PLK,5,2012,1375,752,623,48,40,26,59
PLK,5,2012,2870,1425,1445,185,86,38,121
KVK,5,2012,4134,1928,2206,361,139,91,202
KVK,5,2012,6499,3113,3386,474,200,183,258
KVK,5,2012,6182,3065,3117,415,72,65,321
ULK,5,2012,9295,4629,4666,551,79,94,446
ULK,5,2012,9139,4849,4290,661,133,94,353
ULK,5,2012,6117,3104,3013,440,102,71,292
ULK,5,2012,5783,2967,2816,400,37,56,327
ULK,5,2012,9743,5136,4607,587,67,82,367
ULK,5,2012,8718,4370,4348,486,108,100,316
ULK,5,2012,9230,4306,4924,511,127,81,342
LBK,5,2012,6365,3430,2935,473,115,111,311
LBK,5,2012,4215,2207,2008,380,95,61,220
LBK,5,2012,8583,4470,4113,707,378,322,324
LBK,5,2012,3441,1781,1660,313,77,64,197
HKK,5,2012,6116,3095,3021,543,387,445,459
HKK,5,2012,2779,1458,1321,228,58,62,181
HKK,5,2012,3918,1990,1928,330,200,80,173
HKK,5,2012,2384,1375,1009,217,90,52,100
HKK,5,2012,5646,2814,2832,532,206,178,266
PAK,5,2012,4247,2254,1993,352,131,166,259
PAK,5,2012,5611,2936,2675,623,336,379,272
PAK,5,2012,5177,2622,2555,340,136,110,286
PAK,5,2012,5900,3033,2867,355,171,187,331
VYS,5,2012,3789,2089,1700,306,37,59,214
VYS,5,2012,4793,2395,2398,362,115,140,367
VYS,5,2012,1969,1058,911,145,54,37,78
VYS,5,2012,6338,3429,2909,388,68,55,458
VYS,5,2012,5250,2800,2450,369,124,57,343
JHM,5,2012,4720,2429,2291,333,132,86,314
JHM,5,2012,18351,9307,9044,1311,988,794,696
JHM,5,2012,7549,3919,3630,616,132,262,491
JHM,5,2012,5693,2746,2947,419,135,144,349
JHM,5,2012,10863,5077,5786,779,211,121,609
JHM,5,2012,3861,1928,1933,312,89,79,225
JHM,5,2012,6906,3583,3323,510,153,134,422
OLK,5,2012,3061,1515,1546,290,79,169,116
OLK,5,2012,11490,5924,5566,866,469,617,682
OLK,5,2012,5467,3030,2437,440,99,100,251
OLK,5,2012,7847,4046,3801,479,64,104,393
OLK,5,2012,7423,3742,3681,505,129,119,366
ZLK,5,2012,5852,2875,2977,422,144,128,367
ZLK,5,2012,6220,3278,2942,548,89,69,242
ZLK,5,2012,7299,3526,3773,460,300,192,383
ZLK,5,2012,8097,4273,3824,739,235,175,430
MSK,5,2012,8146,4221,3925,523,75,131,327
MSK,5,2012,8842,4419,4423,813,398,332,404
MSK,5,2012,19579,9813,9766,1253,318,290,897
MSK,5,2012,6965,3415,3550,575,174,105,365
MSK,5,2012,9002,4493,4509,687,129,139,562
MSK,5,2012,20978,10242,10736,1734,676,616,957
PHA,6,2012,33499,16632,16867,3038,1816,1845,894
STC,6,2012,2530,1330,1200,260,66,38,87
STC,6,2012,3151,1692,1459,237,132,34,126
STC,6,2012,7860,4086,3774,507,82,43,286
STC,6,2012,4857,2501,2356,382,62,87,196
STC,6,2012,3618,1980,1638,231,72,181,95
STC,6,2012,4698,2484,2214,319,68,16,234
STC,6,2012,3368,1872,1496,287,104,100,117
STC,6,2012,4389,2316,2073,346,376,416,173
STC,6,2012,2893,1472,1421,296,175,62,122
STC,6,2012,2730,1406,1324,168,46,29,108
STC,6,2012,5329,2586,2743,307,74,66,234
STC,6,2012,2651,1417,1234,165,23,12,161
JHC,6,2012,6130,3240,2890,640,233,177,405
JHC,6,2012,3037,1525,1512,189,127,153,98
JHC,6,2012,2918,1716,1202,182,52,73,134
JHC,6,2012,2353,1333,1020,163,30,67,93
JHC,6,2012,1584,814,770,156,95,74,83
JHC,6,2012,3150,1665,1485,193,82,46,134
JHC,6,2012,4557,2525,2032,362,145,118,203
PLK,6,2012,2392,1325,1067,218,113,113,67
PLK,6,2012,3131,1656,1475,217,90,103,156
PLK,6,2012,6191,3316,2875,491,545,549,221
PLK,6,2012,1722,929,793,119,10,20,80
PLK,6,2012,2446,1324,1122,226,41,31,102
PLK,6,2012,1448,813,635,183,36,61,61
PLK,6,2012,2826,1418,1408,152,91,75,107
KVK,6,2012,4074,1914,2160,267,101,178,216
KVK,6,2012,6403,3071,3332,349,180,193,213
KVK,6,2012,6121,3050,3071,349,88,46,271
ULK,6,2012,9264,4659,4605,540,155,174,378
ULK,6,2012,9061,4827,4234,544,134,129,336
ULK,6,2012,6036,3149,2887,393,106,233,264
ULK,6,2012,5687,2903,2784,299,34,47,306
ULK,6,2012,9519,5039,4480,382,154,95,296
ULK,6,2012,8697,4361,4336,518,123,83,266
ULK,6,2012,9146,4280,4866,456,97,151,264
LBK,6,2012,6212,3342,2870,308,135,205,277
LBK,6,2012,4131,2184,1947,246,123,50,229
LBK,6,2012,8490,4484,4006,595,334,382,292
LBK,6,2012,3431,1795,1636,236,53,69,174
HKK,6,2012,6050,3106,2944,424,312,386,370
HKK,6,2012,2693,1428,1265,184,80,73,146
HKK,6,2012,3791,1972,1819,312,113,112,128
HKK,6,2012,2353,1348,1005,188,106,141,81
HKK,6,2012,5453,2774,2679,328,129,148,219
PAK,6,2012,4128,2244,1884,307,121,130,248
PAK,6,2012,5511,2925,2586,449,324,292,242
PAK,6,2012,5002,2586,2416,258,128,184,239
PAK,6,2012,5685,2953,2732,341,164,245,256
VYS,6,2012,3681,2050,1631,228,56,28,180
VYS,6,2012,4704,2365,2339,309,136,144,303
VYS,6,2012,1920,1051,869,162,61,47,65
VYS,6,2012,6167,3363,2804,304,69,47,352
VYS,6,2012,5137,2768,2369,250,112,84,265
JHM,6,2012,4652,2426,2226,283,59,98,248
JHM,6,2012,18423,9429,8994,1357,596,809,628
JHM,6,2012,7499,3962,3537,584,131,69,403
JHM,6,2012,5519,2642,2877,365,122,146,306
JHM,6,2012,10555,5024,5531,555,145,211,479
JHM,6,2012,3775,1916,1859,297,81,68,195
JHM,6,2012,6596,3486,3110,370,140,102,331
OLK,6,2012,2792,1415,1377,61,38,63,100
OLK,6,2012,11217,5813,5404,796,386,398,560
OLK,6,2012,5289,2963,2326,257,92,87,183
OLK,6,2012,7817,4121,3696,459,138,147,357
OLK,6,2012,7082,3619,3463,295,59,100,297
ZLK,6,2012,5716,2855,2861,318,107,127,294
ZLK,6,2012,6073,3228,2845,351,114,97,205
ZLK,6,2012,7130,3498,3632,401,289,284,298
ZLK,6,2012,7887,4250,3637,538,190,304,385
MSK,6,2012,8022,4230,3792,390,90,64,259
MSK,6,2012,8745,4383,4362,625,279,359,352
MSK,6,2012,19366,9761,9605,961,231,341,753
MSK,6,2012,6837,3424,3413,478,119,264,317
MSK,6,2012,8795,4464,4331,533,130,124,427
MSK,6,2012,20794,10214,10580,1182,590,579,839
PHA,7,2012,34948,17681,17267,3858,1318,1804,872
STC,7,2012,2638,1428,1210,400,47,96,99
STC,7,2012,3140,1730,1410,300,48,80,125
STC,7,2012,7950,4168,3782,604,107,43,293
STC,7,2012,4901,2592,2309,456,123,181,186
STC,7,2012,3717,2055,1662,367,76,378,94
STC,7,2012,4796,2572,2224,448,41,143,257
STC,7,2012,3462,1956,1506,375,89,126,123
STC,7,2012,4469,2388,2081,394,74,118,165
STC,7,2012,3053,1594,1459,490,72,797,119
STC,7,2012,2861,1494,1367,349,23,9,96
STC,7,2012,5515,2737,2778,552,82,81,306
STC,7,2012,2666,1472,1194,248,36,7,158
JHC,7,2012,6438,3491,2947,920,188,298,467
JHC,7,2012,3040,1566,1474,293,54,66,93
JHC,7,2012,2862,1697,1165,328,81,49,133
JHC,7,2012,2398,1378,1020,347,59,38,83
JHC,7,2012,1649,862,787,247,49,62,92
JHC,7,2012,3220,1741,1479,341,62,58,130
JHC,7,2012,4549,2564,1985,391,98,121,214
PLK,7,2012,2432,1385,1047,261,61,40,68
PLK,7,2012,3202,1730,1472,361,69,122,183
PLK,7,2012,6386,3483,2903,685,367,366,289
PLK,7,2012,1765,978,787,205,48,30,91
PLK,7,2012,2588,1439,1149,346,25,54,106
PLK,7,2012,1449,839,610,153,58,23,66
PLK,7,2012,2879,1459,1420,275,62,53,123
KVK,7,2012,4237,2024,2213,489,76,40,280
KVK,7,2012,6512,3178,3334,628,128,138,212
KVK,7,2012,6232,3119,3113,543,85,65,266
ULK,7,2012,9330,4767,4563,681,135,89,376
ULK,7,2012,9117,4893,4224,852,150,114,361
ULK,7,2012,6147,3311,2836,664,69,134,275
ULK,7,2012,5801,3022,2779,507,42,40,291
ULK,7,2012,9709,5191,4518,760,82,119,306
ULK,7,2012,8671,4436,4235,519,105,126,265
ULK,7,2012,9166,4361,4805,700,95,53,232
LBK,7,2012,6250,3417,2833,469,127,123,335
LBK,7,2012,4145,2209,1936,400,134,130,233
LBK,7,2012,8691,4671,4020,842,272,266,409
LBK,7,2012,3551,1896,1655,340,42,42,212
HKK,7,2012,6167,3243,2924,630,315,386,356
HKK,7,2012,2811,1510,1301,336,53,56,145
HKK,7,2012,3949,2112,1837,543,75,55,149
HKK,7,2012,2484,1439,1045,390,53,98,85
HKK,7,2012,5564,2894,2670,579,148,116,228
PAK,7,2012,4428,2513,1915,604,92,197,279
PAK,7,2012,5746,3118,2628,729,178,435,248
PAK,7,2012,5144,2723,2421,517,60,82,245
PAK,7,2012,5811,3070,2741,530,158,146,255
VYS,7,2012,3717,2079,1638,343,40,64,191
VYS,7,2012,4883,2561,2322,530,84,83,317
VYS,7,2012,2034,1173,861,317,72,57,82
VYS,7,2012,6275,3527,2748,554,74,44,382
VYS,7,2012,5351,2983,2368,557,89,117,309
JHM,7,2012,4817,2597,2220,529,75,79,239
JHM,7,2012,19303,10049,9254,2019,651,570,608
JHM,7,2012,7799,4226,3573,929,75,107,420
JHM,7,2012,5661,2786,2875,634,102,135,308
JHM,7,2012,10815,5312,5503,1043,224,205,470
JHM,7,2012,3893,2010,1883,447,55,41,198
JHM,7,2012,6709,3641,3068,648,90,93,338
OLK,7,2012,2729,1388,1341,257,68,65,118
OLK,7,2012,11280,5929,5351,844,478,397,611
OLK,7,2012,5470,3086,2384,524,80,58,185
OLK,7,2012,7932,4258,3674,610,103,75,406
OLK,7,2012,7180,3744,3436,611,97,75,346
ZLK,7,2012,5813,2995,2818,591,67,78,320
ZLK,7,2012,6276,3409,2867,716,63,58,224
ZLK,7,2012,7213,3613,3600,747,258,272,328
ZLK,7,2012,8136,4476,3660,918,192,214,438
MSK,7,2012,8056,4312,3744,544,60,102,258
MSK,7,2012,9016,4592,4424,1111,280,147,413
MSK,7,2012,19458,9944,9514,1520,378,206,743
MSK,7,2012,7075,3582,3493,860,84,107,366
MSK,7,2012,8820,4543,4277,810,121,132,457
MSK,7,2012,21250,10599,10651,1964,534,397,893
PHA,8,2012,35922,18214,17708,3592,1696,1572,1006
STC,8,2012,2756,1466,1290,436,50,44,158
STC,8,2012,3153,1730,1423,319,104,79,144
STC,8,2012,7925,4144,3781,533,73,60,323
STC,8,2012,4990,2631,2359,523,210,123,236
STC,8,2012,3817,2115,1702,336,92,61,129
STC,8,2012,4711,2540,2171,394,101,146,252
STC,8,2012,3496,1978,1518,352,135,79,176
STC,8,2012,4461,2380,2081,392,109,68,194
STC,8,2012,3072,1601,1471,516,158,25,144
STC,8,2012,2820,1505,1315,262,44,65,84
STC,8,2012,5624,2784,2840,498,117,73,405
STC,8,2012,2627,1460,1167,228,28,17,166
JHC,8,2012,6312,3453,2859,737,316,153,494
JHC,8,2012,3063,1585,1478,315,85,109,116
JHC,8,2012,2894,1718,1176,283,72,99,166
JHC,8,2012,2369,1383,986,326,40,51,174
JHC,8,2012,1663,848,815,231,80,93,104
JHC,8,2012,3147,1715,1432,229,58,101,151
JHC,8,2012,4455,2504,1951,372,145,186,220
PLK,8,2012,2450,1382,1068,227,69,81,71
PLK,8,2012,3169,1729,1440,279,110,147,201
PLK,8,2012,6613,3602,3011,719,534,321,426
PLK,8,2012,1785,1002,783,226,54,28,121
PLK,8,2012,2603,1441,1162,337,51,27,133
PLK,8,2012,1421,825,596,104,42,12,66
PLK,8,2012,2866,1454,1412,244,70,70,140
KVK,8,2012,4243,2019,2224,414,108,63,315
KVK,8,2012,6450,3136,3314,561,141,149,236
KVK,8,2012,6271,3144,3127,516,49,72,304
ULK,8,2012,9170,4696,4474,594,84,75,406
ULK,8,2012,9114,4948,4166,757,172,97,409
ULK,8,2012,6050,3249,2801,515,57,38,280
ULK,8,2012,5734,3028,2706,412,73,38,303
ULK,8,2012,9613,5147,4466,645,93,92,458
ULK,8,2012,8631,4454,4177,612,135,134,262
ULK,8,2012,9168,4353,4815,541,123,112,217
LBK,8,2012,6290,3431,2859,445,121,154,310
LBK,8,2012,4147,2206,1941,389,103,137,262
LBK,8,2012,8619,4670,3949,691,400,308,488
LBK,8,2012,3585,1914,1671,293,81,90,247
HKK,8,2012,6244,3288,2956,545,344,380,350
HKK,8,2012,2749,1481,1268,235,43,60,166
HKK,8,2012,3967,2134,1833,427,112,129,193
HKK,8,2012,2591,1505,1086,356,69,71,116
HKK,8,2012,5568,2888,2680,496,114,163,263
PAK,8,2012,4358,2500,1858,423,110,167,331
PAK,8,2012,5725,3142,2583,550,308,326,273
PAK,8,2012,5234,2766,2468,499,145,58,280
PAK,8,2012,5767,3050,2717,401,244,146,296
VYS,8,2012,3794,2137,1657,326,27,28,241
VYS,8,2012,4923,2615,2308,435,119,105,366
VYS,8,2012,2033,1180,853,227,50,65,110
VYS,8,2012,6209,3507,2702,452,45,60,452
VYS,8,2012,5369,2990,2379,425,94,114,383
JHM,8,2012,4848,2622,2226,471,80,83,323
JHM,8,2012,19284,10104,9180,1554,819,652,686
JHM,8,2012,7895,4345,3550,804,106,130,519
JHM,8,2012,5610,2796,2814,450,200,161,350
JHM,8,2012,10729,5280,5449,833,282,145,542
JHM,8,2012,3872,1992,1880,419,128,99,279
JHM,8,2012,6861,3802,3059,575,99,70,410
OLK,8,2012,2697,1370,1327,213,15,29,160
OLK,8,2012,11343,5987,5356,794,415,451,722
OLK,8,2012,5460,3076,2384,500,93,82,231
OLK,8,2012,7927,4225,3702,608,77,44,518
OLK,8,2012,7140,3727,3413,582,88,91,441
ZLK,8,2012,5844,3033,2811,505,163,113,376
ZLK,8,2012,6453,3512,2941,602,94,89,288
ZLK,8,2012,7356,3669,3687,734,150,147,406
ZLK,8,2012,8178,4518,3660,790,229,154,571
MSK,8,2012,7977,4253,3724,444,69,56,271
MSK,8,2012,9002,4595,4407,918,264,277,598
MSK,8,2012,19402,9933,9469,1349,204,255,783
MSK,8,2012,7004,3541,3463,728,204,138,438
MSK,8,2012,8807,4553,4254,759,158,148,489
MSK,8,2012,21204,10616,10588,1619,489,432,945
PHA,9,2012,35831,17937,17894,4248,2729,2284,1212
STC,9,2012,2866,1469,1397,506,100,135,259
STC,9,2012,3250,1753,1497,472,28,55,222
STC,9,2012,7835,4037,3798,667,76,98,433
STC,9,2012,4982,2619,2363,637,115,162,345
STC,9,2012,3836,2076,1760,451,60,61,214
STC,9,2012,4866,2594,2272,661,117,152,378
STC,9,2012,3552,1983,1569,492,102,139,270
STC,9,2012,4470,2345,2125,510,291,214,249
STC,9,2012,3187,1634,1553,657,61,66,260
STC,9,2012,2953,1552,1401,460,39,39,94
STC,9,2012,5674,2825,2849,711,103,93,462
STC,9,2012,2699,1483,1216,381,17,27,222
JHC,9,2012,6416,3488,2928,1007,287,531,656
JHC,9,2012,3191,1644,1547,442,43,43,172
JHC,9,2012,2952,1731,1221,501,70,75,249
JHC,9,2012,2446,1392,1054,461,37,49,363
JHC,9,2012,1668,828,840,280,143,193,148
JHC,9,2012,3235,1744,1491,425,65,70,258
JHC,9,2012,4453,2468,1985,569,163,130,312
PLK,9,2012,2362,1340,1022,280,128,115,57
PLK,9,2012,3243,1747,1496,503,80,118,287
PLK,9,2012,6231,3343,2888,658,426,533,447
PLK,9,2012,1781,984,797,265,22,36,173
PLK,9,2012,2612,1449,1163,463,37,40,185
PLK,9,2012,1371,771,600,120,59,79,65
PLK,9,2012,2947,1489,1458,417,85,85,215
KVK,9,2012,4255,2000,2255,485,59,97,369
KVK,9,2012,6490,3103,3387,714,135,153,379
KVK,9,2012,6391,3191,3200,688,63,66,470
ULK,9,2012,9219,4679,4540,955,100,130,565
ULK,9,2012,9327,5052,4275,1076,245,268,594
ULK,9,2012,6284,3341,2943,910,83,151,467
ULK,9,2012,5831,3079,2752,757,30,63,402
ULK,9,2012,9689,5211,4478,912,146,131,669
ULK,9,2012,8824,4526,4298,840,59,74,317
ULK,9,2012,9126,4296,4830,684,87,124,264
LBK,9,2012,6313,3457,2856,671,193,174,372
LBK,9,2012,4214,2235,1979,570,78,80,331
LBK,9,2012,8590,4634,3956,967,415,391,561
LBK,9,2012,3666,1941,1725,500,30,42,344
HKK,9,2012,6444,3353,3091,817,508,376,415
HKK,9,2012,2778,1470,1308,398,48,66,245
HKK,9,2012,4009,2105,1904,657,80,149,268
HKK,9,2012,2695,1541,1154,465,24,79,239
HKK,9,2012,5771,2986,2785,829,116,134,448
PAK,9,2012,4467,2490,1977,681,102,90,485
PAK,9,2012,5809,3134,2675,771,169,366,406
PAK,9,2012,5297,2738,2559,651,74,68,446
PAK,9,2012,5894,3095,2799,756,135,205,442
VYS,9,2012,3847,2128,1719,516,20,53,339
VYS,9,2012,4976,2580,2396,675,91,128,547
VYS,9,2012,2007,1142,865,359,43,88,165
VYS,9,2012,6325,3548,2777,708,124,84,614
VYS,9,2012,5353,2928,2425,649,146,125,556
JHM,9,2012,4916,2648,2268,663,54,62,493
JHM,9,2012,19503,10123,9380,2168,628,652,889
JHM,9,2012,8097,4383,3714,1293,185,165,743
JHM,9,2012,5818,2882,2936,821,117,152,562
JHM,9,2012,10957,5350,5607,1291,148,154,815
JHM,9,2012,3943,2011,1932,576,30,61,353
JHM,9,2012,6827,3735,3092,771,139,246,627
OLK,9,2012,2741,1399,1342,325,43,36,221
OLK,9,2012,11405,5952,5453,1247,361,461,1025
OLK,9,2012,5576,3183,2393,694,128,148,385
OLK,9,2012,8048,4269,3779,772,113,176,692
OLK,9,2012,7266,3765,3501,846,115,162,578
ZLK,9,2012,5870,3023,2847,703,106,148,523
ZLK,9,2012,6509,3502,3007,773,89,143,461
ZLK,9,2012,7534,3736,3798,1022,162,338,669
ZLK,9,2012,8190,4480,3710,1055,178,212,752
MSK,9,2012,8137,4306,3831,785,43,55,395
MSK,9,2012,9368,4769,4599,1395,343,424,899
MSK,9,2012,19725,10062,9663,1927,317,458,1044
MSK,9,2012,7256,3647,3609,1101,106,136,621
MSK,9,2012,9126,4706,4420,1236,104,136,689
MSK,9,2012,21573,10723,10850,2404,597,640,1237
PHA,10,2012,36094,18088,18006,4273,1655,619,1267
STC,10,2012,2915,1461,1454,470,204,227,274
STC,10,2012,3269,1770,1499,373,73,85,242
STC,10,2012,7991,4085,3906,743,116,137,482
STC,10,2012,4966,2587,2379,527,123,100,343
STC,10,2012,3850,2084,1766,379,117,129,238
STC,10,2012,4948,2640,2308,506,86,113,400
STC,10,2012,3597,2000,1597,433,113,47,259
STC,10,2012,4537,2368,2169,433,80,252,292
STC,10,2012,3175,1625,1550,563,345,115,277
STC,10,2012,2973,1561,1412,397,79,185,107
STC,10,2012,5611,2797,2814,585,122,54,434
STC,10,2012,2694,1476,1218,272,27,82,230
JHC,10,2012,6397,3447,2950,823,607,505,676
JHC,10,2012,3257,1686,1571,400,52,87,198
JHC,10,2012,3145,1849,1296,519,87,115,278
JHC,10,2012,2421,1405,1016,372,101,26,410
JHC,10,2012,1728,849,879,287,75,72,163
JHC,10,2012,3221,1771,1450,315,76,137,241
JHC,10,2012,4475,2478,1997,470,173,159,313
PLK,10,2012,2429,1390,1039,261,72,135,75
PLK,10,2012,3319,1774,1545,437,53,163,289
PLK,10,2012,6521,3455,3066,895,616,835,632
PLK,10,2012,1825,992,833,235,31,235,164
PLK,10,2012,2643,1483,1160,334,31,25,170
PLK,10,2012,1458,834,624,473,32,38,106
PLK,10,2012,3009,1493,1516,340,91,3,209
KVK,10,2012,4371,2041,2330,511,161,57,446
KVK,10,2012,6542,3131,3411,685,219,244,403
KVK,10,2012,6290,3116,3174,504,58,79,433
ULK,10,2012,9223,4665,4558,744,108,165,595
ULK,10,2012,9337,5090,4247,873,72,428,630
ULK,10,2012,6302,3387,2915,615,145,39,469
ULK,10,2012,5859,3065,2794,522,91,20,419
ULK,10,2012,9638,5168,4470,776,132,143,780
ULK,10,2012,8798,4522,4276,671,84,105,316
ULK,10,2012,9129,4284,4845,678,119,153,331
LBK,10,2012,6231,3421,2810,552,105,135,433
LBK,10,2012,4267,2274,1993,441,83,14,365
LBK,10,2012,8634,4607,4027,848,232,234,600
LBK,10,2012,3715,1976,1739,394,189,124,342
HKK,10,2012,6554,3393,3161,662,462,645,443
HKK,10,2012,2865,1521,1344,354,142,114,257
HKK,10,2012,4102,2125,1977,530,119,150,299
HKK,10,2012,2748,1558,1190,341,64,38,274
HKK,10,2012,5765,2909,2856,674,109,157,463
PAK,10,2012,4544,2496,2048,513,143,218,481
PAK,10,2012,5871,3143,2728,657,204,158,471
PAK,10,2012,5280,2709,2571,456,138,267,461
PAK,10,2012,6049,3205,2844,677,132,121,515
VYS,10,2012,3868,2147,1721,388,85,114,353
VYS,10,2012,5017,2550,2467,501,143,167,568
VYS,10,2012,2006,1154,852,298,38,91,170
VYS,10,2012,6313,3526,2787,544,153,59,596
VYS,10,2012,5324,2904,2420,438,140,76,551
JHM,10,2012,4880,2596,2284,472,83,133,474
JHM,10,2012,19497,10082,9415,1762,627,503,1019
JHM,10,2012,7999,4303,3696,859,164,296,748
JHM,10,2012,5880,2908,2972,570,135,179,584
JHM,10,2012,10902,5271,5631,842,168,339,831
JHM,10,2012,3997,2042,1955,454,91,109,385
JHM,10,2012,6954,3756,3198,681,111,231,641
OLK,10,2012,2783,1432,1351,284,13,72,228
OLK,10,2012,11805,6153,5652,1140,379,453,1143
OLK,10,2012,5641,3220,2421,577,91,207,406
OLK,10,2012,8035,4223,3812,562,113,116,701
OLK,10,2012,7331,3781,3550,696,97,241,634
ZLK,10,2012,5899,3028,2871,503,148,67,544
ZLK,10,2012,6603,3511,3092,615,110,125,454
ZLK,10,2012,7894,3849,4045,1023,203,52,694
ZLK,10,2012,8133,4440,3693,850,176,166,717
MSK,10,2012,8168,4281,3887,560,73,102,435
MSK,10,2012,9442,4779,4663,1066,308,171,893
MSK,10,2012,19682,9996,9686,1637,279,141,1114
MSK,10,2012,7396,3714,3682,907,100,149,653
MSK,10,2012,9100,4636,4464,885,138,109,709
MSK,10,2012,21631,10662,10969,1912,372,210,1343
PHA,11,2012,36122,18056,18066,3461,1348,451,1301
STC,11,2012,3052,1494,1558,445,168,145,266
STC,11,2012,3380,1801,1579,374,43,93,245
STC,11,2012,8086,4084,4002,551,118,94,482
STC,11,2012,5033,2593,2440,502,150,177,331
STC,11,2012,3955,2122,1833,402,85,141,215
STC,11,2012,5048,2669,2379,462,237,75,368
STC,11,2012,3656,2012,1644,390,180,73,247
STC,11,2012,4619,2378,2241,410,58,103,269
STC,11,2012,3229,1645,1584,425,87,470,277
STC,11,2012,2933,1550,1383,330,37,27,94
STC,11,2012,5784,2841,2943,597,116,110,411
STC,11,2012,2717,1485,1232,260,16,15,220
JHC,11,2012,6620,3495,3125,747,236,226,666
JHC,11,2012,3498,1784,1714,460,48,58,195
JHC,11,2012,3440,1954,1486,547,44,85,270
JHC,11,2012,2509,1405,1104,419,116,51,230
JHC,11,2012,1805,853,952,286,138,16,137
JHC,11,2012,3367,1790,1577,378,24,42,232
JHC,11,2012,4628,2503,2125,545,78,118,310
PLK,11,2012,2466,1382,1084,224,64,83,83
PLK,11,2012,3570,1906,1664,532,56,46,287
PLK,11,2012,6597,3471,3126,758,326,265,608
PLK,11,2012,1848,988,860,228,25,13,147
PLK,11,2012,2724,1502,1222,340,40,59,161
PLK,11,2012,1550,875,675,195,13,64,108
PLK,11,2012,3074,1524,1550,280,26,148,207
KVK,11,2012,4463,2080,2383,475,79,80,476
KVK,11,2012,6614,3103,3511,641,81,393,392
KVK,11,2012,6400,3162,3238,533,87,20,429
ULK,11,2012,9477,4749,4728,834,116,136,586
ULK,11,2012,9522,5133,4389,818,86,63,648
ULK,11,2012,6460,3387,3073,651,90,134,448
ULK,11,2012,5932,3066,2866,494,83,132,411
ULK,11,2012,9656,5151,4505,685,34,88,838
ULK,11,2012,8843,4502,4341,652,48,30,329
ULK,11,2012,9211,4304,4907,630,130,74,341
LBK,11,2012,6310,3431,2879,572,67,166,452
LBK,11,2012,4314,2245,2069,414,88,66,353
LBK,11,2012,8735,4595,4140,807,267,385,615
LBK,11,2012,3838,2008,1830,391,52,103,342
HKK,11,2012,6762,3455,3307,646,276,348,456
HKK,11,2012,3012,1571,1441,368,49,86,255
HKK,11,2012,4302,2187,2115,587,105,106,297
HKK,11,2012,2824,1577,1247,326,61,59,254
HKK,11,2012,5972,2934,3038,683,159,174,448
PAK,11,2012,4744,2542,2202,561,87,71,456
PAK,11,2012,6033,3171,2862,598,288,167,487
PAK,11,2012,5475,2758,2717,542,150,90,461
PAK,11,2012,6153,3168,2985,570,157,224,538
VYS,11,2012,4047,2204,1843,435,33,104,347
VYS,11,2012,5248,2626,2622,540,127,115,597
VYS,11,2012,2113,1199,914,317,26,75,168
VYS,11,2012,6658,3678,2980,717,139,218,581
VYS,11,2012,5584,2974,2610,527,89,226,529
JHM,11,2012,4879,2585,2294,434,50,38,447
JHM,11,2012,19679,10139,9540,1566,590,777,1037
JHM,11,2012,8220,4368,3852,870,176,275,717
JHM,11,2012,6199,3014,3185,759,87,89,552
JHM,11,2012,11084,5272,5812,863,124,137,799
JHM,11,2012,4052,2027,2025,368,30,46,357
JHM,11,2012,7527,4083,3444,952,76,73,649
OLK,11,2012,3037,1485,1552,460,16,12,211
OLK,11,2012,12244,6261,5983,1098,339,350,1119
OLK,11,2012,5766,3207,2559,538,95,93,428
OLK,11,2012,8230,4258,3972,597,108,173,708
OLK,11,2012,7677,3888,3789,781,91,48,643
ZLK,11,2012,6095,3061,3034,540,64,118,529
ZLK,11,2012,6724,3498,3226,569,75,121,423
ZLK,11,2012,8163,3927,4236,821,83,327,654
ZLK,11,2012,8320,4509,3811,865,167,215,704
MSK,11,2012,8344,4290,4054,607,67,76,435
MSK,11,2012,9715,4781,4934,1069,210,492,852
MSK,11,2012,19781,9979,9802,1386,175,444,1073
MSK,11,2012,7563,3696,3867,860,114,114,634
MSK,11,2012,9205,4563,4642,850,109,114,676
MSK,11,2012,21982,10662,11320,1788,438,825,1302
PHA,12,2012,36771,18245,18526,2955,1004,3165,1295
STC,12,2012,3288,1536,1752,442,60,17,265
STC,12,2012,3583,1867,1716,366,31,53,247
STC,12,2012,8346,4152,4194,472,45,42,488
STC,12,2012,5486,2711,2775,668,67,103,329
STC,12,2012,4231,2158,2073,471,32,49,214
STC,12,2012,5248,2739,2509,467,26,29,372
STC,12,2012,3763,2036,1727,337,122,78,241
STC,12,2012,4876,2430,2446,485,36,60,270
STC,12,2012,3314,1660,1654,388,78,36,266
STC,12,2012,3043,1591,1452,293,32,86,94
STC,12,2012,6348,2933,3415,849,42,32,415
STC,12,2012,2925,1520,1405,338,16,3,225
JHC,12,2012,6988,3524,3464,852,118,117,661
JHC,12,2012,3859,1826,2033,551,81,54,205
JHC,12,2012,4108,2088,2020,843,22,44,276
JHC,12,2012,2953,1487,1466,595,49,80,230
JHC,12,2012,2110,870,1240,424,64,144,129
JHC,12,2012,3682,1806,1876,488,22,52,212
JHC,12,2012,5067,2525,2542,691,62,107,311
PLK,12,2012,2600,1375,1225,256,31,23,95
PLK,12,2012,4042,1946,2096,672,54,4,278
PLK,12,2012,7056,3612,3444,768,223,297,677
PLK,12,2012,2025,1007,1018,282,23,30,146
PLK,12,2012,2942,1553,1389,356,25,15,160
PLK,12,2012,1673,929,744,209,32,15,108
PLK,12,2012,3386,1601,1785,487,19,1,212
KVK,12,2012,4766,2171,2595,514,38,162,463
KVK,12,2012,6942,3165,3777,714,90,148,393
KVK,12,2012,6703,3239,3464,542,14,21,425
ULK,12,2012,9981,4809,5172,903,38,79,590
ULK,12,2012,9883,5210,4673,753,40,61,636
ULK,12,2012,6923,3421,3502,830,103,53,436
ULK,12,2012,6402,3159,3243,677,44,6,439
ULK,12,2012,9890,5229,4661,638,33,112,896
ULK,12,2012,9077,4561,4516,657,64,53,323
ULK,12,2012,9433,4369,5064,578,73,97,335
LBK,12,2012,6605,3497,3108,582,52,169,456
LBK,12,2012,4470,2246,2224,411,38,41,347
LBK,12,2012,9111,4616,4495,831,260,252,637
LBK,12,2012,3999,1987,2012,416,25,12,348
HKK,12,2012,7370,3521,3849,890,266,358,456
HKK,12,2012,3374,1631,1743,523,39,23,268
HKK,12,2012,4798,2263,2535,716,66,105,325
HKK,12,2012,3216,1659,1557,558,17,47,241
HKK,12,2012,6452,2991,3461,840,66,163,427
PAK,12,2012,5645,2639,3006,1090,30,77,487
PAK,12,2012,6555,3258,3297,789,172,346,483
PAK,12,2012,6265,2919,3346,966,52,128,487
PAK,12,2012,6799,3278,3521,803,60,38,555
VYS,12,2012,4548,2268,2280,659,18,9,336
VYS,12,2012,5841,2739,3102,807,60,93,694
VYS,12,2012,2597,1274,1323,589,44,25,171
VYS,12,2012,7735,3893,3842,1192,49,96,580
VYS,12,2012,6242,3086,3156,865,39,69,527
JHM,12,2012,5222,2668,2554,602,87,52,444
JHM,12,2012,20154,10231,9923,1438,421,704,1075
JHM,12,2012,8826,4469,4357,978,314,30,719
JHM,12,2012,7055,3223,3832,1061,47,89,546
JHM,12,2012,12288,5479,6809,1556,54,98,798
JHM,12,2012,4324,2038,2286,495,13,47,355
JHM,12,2012,8566,4278,4288,1178,74,91,642
OLK,12,2012,3500,1558,1942,587,16,9,223
OLK,12,2012,13251,6348,6903,1309,151,299,1103
OLK,12,2012,6223,3301,2922,698,44,27,473
OLK,12,2012,8910,4324,4586,1009,25,55,662
OLK,12,2012,8458,4015,4443,1097,61,45,649
ZLK,12,2012,6518,3085,3433,681,36,78,525
ZLK,12,2012,7421,3584,3837,919,39,48,415
ZLK,12,2012,9122,4112,5010,1223,86,50,664
ZLK,12,2012,9039,4623,4416,1102,97,105,705
MSK,12,2012,9196,4403,4793,1105,63,57,442
MSK,12,2012,10349,4848,5501,1161,137,234,846
MSK,12,2012,20319,10024,10295,1422,121,267,1067
MSK,12,2012,8192,3782,4410,1042,72,79,613
MSK,12,2012,10261,4617,5644,1497,79,177,689
MSK,12,2012,22782,10758,12024,1747,209,245,1283
PHA,1,2013,38771,18859,19912,5610,1845,3973,1276
STC,1,2013,3623,1595,2028,713,93,96,254
STC,1,2013,3849,1913,1936,584,81,126,235
STC,1,2013,8679,4235,4444,853,109,120,486
STC,1,2013,5901,2804,3097,852,129,153,326
STC,1,2013,4632,2222,2410,716,112,100,205
STC,1,2013,5655,2826,2829,831,144,46,361
STC,1,2013,3977,2117,1860,653,160,150,225
STC,1,2013,5140,2485,2655,631,400,294,266
STC,1,2013,3573,1732,1841,768,256,54,246
STC,1,2013,3127,1585,1542,531,29,116,92
STC,1,2013,6973,3106,3867,1009,71,81,411
STC,1,2013,3118,1572,1546,407,44,67,223
JHC,1,2013,7665,3624,4041,1470,288,269,652
JHC,1,2013,4289,1918,2371,756,53,54,187
JHC,1,2013,4859,2273,2586,1006,74,32,271
JHC,1,2013,3352,1576,1776,698,103,86,223
JHC,1,2013,2395,877,1518,480,77,83,114
JHC,1,2013,4048,1835,2213,666,52,115,202
JHC,1,2013,5617,2669,2948,974,148,121,310
PLK,1,2013,2952,1456,1496,509,59,41,117
PLK,1,2013,4472,2003,2469,828,85,115,253
PLK,1,2013,7838,3812,4026,1521,365,301,650
PLK,1,2013,2272,1055,1217,441,39,18,150
PLK,1,2013,3285,1640,1645,590,77,45,160
PLK,1,2013,1844,986,858,318,68,52,120
PLK,1,2013,3608,1645,1963,557,96,93,202
KVK,1,2013,5124,2254,2870,745,84,153,420
KVK,1,2013,7382,3316,4066,1010,162,127,386
KVK,1,2013,7157,3361,3796,893,51,96,437
ULK,1,2013,10636,4954,5682,1363,125,136,636
ULK,1,2013,10460,5341,5119,1311,149,71,630
ULK,1,2013,7497,3526,3971,1069,167,175,457
ULK,1,2013,6872,3302,3570,908,92,125,447
ULK,1,2013,10693,5550,5143,1339,59,241,902
ULK,1,2013,9334,4545,4789,923,120,78,312
ULK,1,2013,9770,4422,5348,1018,98,176,348
LBK,1,2013,7020,3631,3389,902,159,14,462
LBK,1,2013,4723,2301,2422,650,131,198,355
LBK,1,2013,9581,4724,4857,1270,351,434,491
LBK,1,2013,4392,2039,2353,681,111,99,340
HKK,1,2013,7875,3599,4276,1049,598,211,439
HKK,1,2013,3592,1636,1956,547,65,87,268
HKK,1,2013,5208,2315,2893,918,140,102,345
HKK,1,2013,3540,1759,1781,644,52,50,229
HKK,1,2013,7085,3134,3951,1175,123,227,425
PAK,1,2013,6283,2733,3550,1059,123,110,483
PAK,1,2013,6995,3312,3683,1154,412,327,489
PAK,1,2013,6838,2968,3870,915,107,153,514
PAK,1,2013,7467,3358,4109,1078,238,391,560
VYS,1,2013,4926,2315,2611,667,57,47,321
VYS,1,2013,6427,2832,3595,1009,109,85,691
VYS,1,2013,2911,1322,1589,571,73,37,163
VYS,1,2013,8160,3918,4242,909,129,118,583
VYS,1,2013,6752,3174,3578,913,151,139,503
JHM,1,2013,5582,2748,2834,789,97,92,436
JHM,1,2013,20918,10382,10536,2530,789,487,1019
JHM,1,2013,9401,4561,4840,1403,333,395,684
JHM,1,2013,7627,3320,4307,1097,115,73,522
JHM,1,2013,13110,5456,7654,1575,188,125,756
JHM,1,2013,4586,2051,2535,665,49,44,336
JHM,1,2013,9463,4410,5053,1477,113,103,613
OLK,1,2013,3933,1646,2287,662,24,29,233
OLK,1,2013,14626,6631,7995,2065,421,168,1096
OLK,1,2013,6721,3399,3322,887,122,116,572
OLK,1,2013,9682,4452,5230,1223,109,64,651
OLK,1,2013,9012,4092,4920,1128,100,82,625
ZLK,1,2013,7058,3160,3898,988,115,62,517
ZLK,1,2013,7981,3639,4342,1070,123,91,411
ZLK,1,2013,9932,4229,5703,1557,142,198,633
ZLK,1,2013,9874,4769,5105,1573,277,238,676
MSK,1,2013,9733,4447,5286,1100,94,120,440
MSK,1,2013,11116,5010,6106,1730,226,288,815
MSK,1,2013,21303,10277,11026,2333,177,236,1070
MSK,1,2013,8764,3887,4877,1347,93,87,593
MSK,1,2013,10966,4706,6260,1597,156,136,692
MSK,1,2013,24207,11125,13082,3047,888,901,1281
PHA,2,2013,39949,19246,20703,4070,0,0,1285
STC,2,2013,3701,1616,2085,393,0,0,256
STC,2,2013,3878,1914,1964,336,0,0,229
STC,2,2013,8816,4238,4578,513,0,0,466
STC,2,2013,6048,2875,3173,493,0,0,322
STC,2,2013,4643,2226,2417,325,0,0,193
STC,2,2013,5676,2808,2868,425,0,0,348
STC,2,2013,4005,2126,1879,401,0,0,227
STC,2,2013,5197,2504,2693,389,0,0,259
STC,2,2013,3704,1775,1929,570,0,0,253
STC,2,2013,3224,1599,1625,327,0,0,93
STC,2,2013,7129,3165,3964,527,0,0,409
STC,2,2013,3114,1552,1562,219,0,0,208
JHC,2,2013,7737,3641,4096,738,0,0,670
JHC,2,2013,4275,1911,2364,310,0,0,192
JHC,2,2013,4936,2270,2666,377,0,0,265
JHC,2,2013,3419,1580,1839,297,0,0,232
JHC,2,2013,2464,911,1553,244,0,0,114
JHC,2,2013,4132,1875,2257,328,0,0,197
JHC,2,2013,5699,2699,3000,477,0,0,342
PLK,2,2013,2967,1438,1529,201,0,0,143
PLK,2,2013,4472,1997,2475,317,0,0,258
PLK,2,2013,7982,3895,4087,858,0,0,406
PLK,2,2013,2310,1102,1208,240,0,0,134
PLK,2,2013,3332,1654,1678,314,0,0,148
PLK,2,2013,1841,971,870,201,0,0,113
PLK,2,2013,3627,1638,1989,300,0,0,196
KVK,2,2013,5173,2244,2929,385,0,0,395
KVK,2,2013,7471,3325,4146,579,0,0,389
KVK,2,2013,7221,3367,3854,489,0,0,416
ULK,2,2013,10658,4986,5672,594,0,0,645
ULK,2,2013,10575,5389,5186,781,0,0,627
ULK,2,2013,7588,3499,4089,624,0,0,442
ULK,2,2013,7027,3376,3651,532,0,0,452
ULK,2,2013,10839,5573,5266,652,0,0,857
ULK,2,2013,9381,4564,4817,516,0,0,374
ULK,2,2013,9944,4459,5485,616,0,0,359
LBK,2,2013,7115,3678,3437,512,0,0,469
LBK,2,2013,4781,2335,2446,398,0,0,366
LBK,2,2013,9710,4746,4964,814,0,0,473
LBK,2,2013,4422,2079,2343,309,0,0,354
HKK,2,2013,8030,3615,4415,583,0,0,422
HKK,2,2013,3627,1647,1980,267,0,0,286
HKK,2,2013,5258,2323,2935,439,0,0,357
HKK,2,2013,3614,1788,1826,374,0,0,230
HKK,2,2013,7168,3164,4004,526,0,0,427
PAK,2,2013,6345,2747,3598,422,0,0,488
PAK,2,2013,7062,3286,3776,547,0,0,472
PAK,2,2013,6976,3027,3949,450,0,0,521
PAK,2,2013,7595,3372,4223,544,0,0,572
VYS,2,2013,4921,2319,2602,300,0,0,329
VYS,2,2013,6478,2883,3595,452,0,0,680
VYS,2,2013,2900,1328,1572,267,0,0,165
VYS,2,2013,8181,3924,4257,453,0,0,592
VYS,2,2013,6706,3121,3585,414,0,0,496
JHM,2,2013,5601,2721,2880,445,0,0,423
JHM,2,2013,21286,10492,10794,1694,0,0,1045
JHM,2,2013,9471,4577,4894,821,0,0,691
JHM,2,2013,7639,3339,4300,524,0,0,519
JHM,2,2013,13052,5432,7620,755,0,0,763
JHM,2,2013,4644,2071,2573,369,0,0,339
JHM,2,2013,9522,4421,5101,496,0,0,610
OLK,2,2013,4026,1663,2363,267,0,0,227
OLK,2,2013,14874,6680,8194,1015,0,0,1111
OLK,2,2013,6787,3447,3340,486,0,0,574
OLK,2,2013,9771,4478,5293,526,0,0,658
OLK,2,2013,9097,4143,4954,554,0,0,609
ZLK,2,2013,7152,3170,3982,506,0,0,522
ZLK,2,2013,7942,3605,4337,533,0,0,385
ZLK,2,2013,10094,4259,5835,704,0,0,624
ZLK,2,2013,10102,4881,5221,880,0,0,680
MSK,2,2013,9811,4468,5343,523,0,0,462
MSK,2,2013,11327,5089,6238,922,0,0,850
MSK,2,2013,21678,10427,11251,1372,0,0,1068
MSK,2,2013,8885,3912,4973,728,0,0,603
MSK,2,2013,11077,4714,6363,808,0,0,720
MSK,2,2013,24802,11323,13479,1803,0,0,1384
PHA,3,2013,40762,19502,21260,3967,0,0,1293
STC,3,2013,3574,1602,1972,356,0,0,243
STC,3,2013,3859,1899,1960,331,0,0,221
STC,3,2013,8897,4259,4638,505,0,0,448
STC,3,2013,5883,2824,3059,432,0,0,299
STC,3,2013,4517,2190,2327,321,0,0,173
STC,3,2013,5670,2822,2848,442,0,0,366
STC,3,2013,4088,2191,1897,388,0,0,223
STC,3,2013,5209,2517,2692,382,0,0,256
STC,3,2013,3718,1751,1967,509,0,0,257
STC,3,2013,3325,1638,1687,361,0,0,100
STC,3,2013,6937,3118,3819,469,0,0,401
STC,3,2013,3067,1540,1527,226,0,0,220
JHC,3,2013,7597,3628,3969,717,0,0,694
JHC,3,2013,4068,1893,2175,284,0,0,189
JHC,3,2013,4661,2188,2473,335,0,0,257
JHC,3,2013,3294,1525,1769,286,0,0,227
JHC,3,2013,2213,896,1317,166,0,0,112
JHC,3,2013,4117,1916,2201,303,0,0,205
JHC,3,2013,5485,2676,2809,405,0,0,346
PLK,3,2013,2952,1459,1493,243,0,0,146
PLK,3,2013,4193,1955,2238,344,0,0,252
PLK,3,2013,8009,3969,4040,864,0,0,471
PLK,3,2013,2259,1082,1177,214,0,0,131
PLK,3,2013,3220,1646,1574,311,0,0,148
PLK,3,2013,1851,980,871,182,0,0,114
PLK,3,2013,3508,1612,1896,250,0,0,182
KVK,3,2013,5116,2229,2887,383,0,0,374
KVK,3,2013,7440,3293,4147,583,0,0,378
KVK,3,2013,7109,3309,3800,460,0,0,396
ULK,3,2013,10628,4969,5659,639,0,0,646
ULK,3,2013,10646,5398,5248,742,0,0,613
ULK,3,2013,7449,3456,3993,538,0,0,443
ULK,3,2013,6936,3331,3605,500,0,0,447
ULK,3,2013,10878,5563,5315,748,0,0,856
ULK,3,2013,9492,4602,4890,693,0,0,404
ULK,3,2013,10077,4521,5556,682,0,0,379
LBK,3,2013,7117,3681,3436,533,0,0,473
LBK,3,2013,4770,2337,2433,465,0,0,340
LBK,3,2013,9808,4768,5040,980,0,0,477
LBK,3,2013,4392,2081,2311,353,0,0,342
HKK,3,2013,7937,3604,4333,539,0,0,413
HKK,3,2013,3520,1667,1853,277,0,0,284
HKK,3,2013,5299,2355,2944,464,0,0,365
HKK,3,2013,3561,1791,1770,290,0,0,224
HKK,3,2013,7163,3243,3920,559,0,0,421
PAK,3,2013,5851,2647,3204,453,0,0,462
PAK,3,2013,7213,3398,3815,691,0,0,504
PAK,3,2013,6821,3027,3794,407,0,0,523
PAK,3,2013,7494,3315,4179,514,0,0,562
VYS,3,2013,4745,2284,2461,319,0,0,333
VYS,3,2013,6353,2852,3501,425,0,0,679
VYS,3,2013,2862,1305,1557,268,0,0,166
VYS,3,2013,7897,3835,4062,449,0,0,599
VYS,3,2013,6701,3138,3563,492,0,0,516
JHM,3,2013,5458,2665,2793,400,0,0,430
JHM,3,2013,21440,10583,10857,1601,0,0,1111
JHM,3,2013,9390,4549,4841,761,0,0,696
JHM,3,2013,7171,3199,3972,462,0,0,512
JHM,3,2013,12514,5346,7168,691,0,0,750
JHM,3,2013,4524,2030,2494,353,0,0,343
JHM,3,2013,8994,4338,4656,446,0,0,599
OLK,3,2013,4030,1702,2328,256,0,0,233
OLK,3,2013,14705,6716,7989,1006,0,0,1089
OLK,3,2013,6574,3413,3161,478,0,0,554
OLK,3,2013,9446,4377,5069,462,0,0,641
OLK,3,2013,9054,4141,4913,567,0,0,581
ZLK,3,2013,7040,3161,3879,479,0,0,526
ZLK,3,2013,7843,3603,4240,539,0,0,369
ZLK,3,2013,10021,4220,5801,636,0,0,616
ZLK,3,2013,10009,4794,5215,765,0,0,661
MSK,3,2013,9668,4408,5260,469,0,0,459
MSK,3,2013,11102,5054,6048,901,0,0,863
MSK,3,2013,21852,10515,11337,1354,0,0,1118
MSK,3,2013,8798,3908,4890,682,0,0,593
MSK,3,2013,10842,4713,6129,768,0,0,703
MSK,3,2013,25085,11455,13630,1784,0,0,1398
PHA,4,2013,40928,19604,21324,4017,0,0,1274
STC,4,2013,3332,1563,1769,358,0,0,223
STC,4,2013,3818,1901,1917,341,0,0,216
STC,4,2013,8855,4276,4579,671,0,0,449
STC,4,2013,5685,2814,2871,477,0,0,292
STC,4,2013,4163,2057,2106,274,0,0,167
STC,4,2013,5550,2763,2787,445,0,0,353
STC,4,2013,4064,2179,1885,403,0,0,228
STC,4,2013,5057,2486,2571,422,0,0,244
STC,4,2013,3662,1761,1901,491,0,0,240
STC,4,2013,3365,1668,1697,348,0,0,91
STC,4,2013,6679,3086,3593,511,0,0,368
STC,4,2013,2932,1504,1428,207,0,0,208
JHC,4,2013,7391,3667,3724,770,0,0,688
JHC,4,2013,3805,1838,1967,349,0,0,195
JHC,4,2013,4106,2062,2044,375,0,0,241
JHC,4,2013,2965,1457,1508,343,0,0,211
JHC,4,2013,1940,863,1077,192,0,0,123
JHC,4,2013,3772,1863,1909,270,0,0,194
JHC,4,2013,5122,2586,2536,413,0,0,334
PLK,4,2013,2779,1438,1341,231,0,0,166
PLK,4,2013,3914,1912,2002,363,0,0,257
PLK,4,2013,7880,3955,3925,803,0,0,485
PLK,4,2013,2148,1055,1093,227,0,0,141
PLK,4,2013,3039,1572,1467,320,0,0,162
PLK,4,2013,1759,934,825,197,0,0,116
PLK,4,2013,3205,1534,1671,238,0,0,186
KVK,4,2013,4911,2164,2747,464,0,0,329
KVK,4,2013,7219,3183,4036,633,0,0,360
KVK,4,2013,7024,3287,3737,537,0,0,389
ULK,4,2013,10265,4897,5368,676,0,0,619
ULK,4,2013,10621,5421,5200,848,0,0,593
ULK,4,2013,7244,3435,3809,620,0,0,427
ULK,4,2013,6835,3352,3483,591,0,0,423
ULK,4,2013,10882,5518,5364,810,0,0,844
ULK,4,2013,9332,4534,4798,609,0,0,441
ULK,4,2013,9924,4503,5421,728,0,0,374
LBK,4,2013,6912,3578,3334,572,0,0,472
LBK,4,2013,4738,2351,2387,459,0,0,316
LBK,4,2013,9733,4814,4919,842,0,0,470
LBK,4,2013,4217,2089,2128,432,0,0,324
HKK,4,2013,7533,3512,4021,520,0,0,412
HKK,4,2013,3215,1603,1612,277,0,0,253
HKK,4,2013,4983,2289,2694,511,0,0,336
HKK,4,2013,3401,1754,1647,336,0,0,218
HKK,4,2013,7032,3266,3766,695,0,0,420
PAK,4,2013,5337,2586,2751,492,0,0,416
PAK,4,2013,7010,3399,3611,716,0,0,491
PAK,4,2013,6204,2891,3313,460,0,0,487
PAK,4,2013,7063,3259,3804,596,0,0,525
VYS,4,2013,4436,2262,2174,338,0,0,321
VYS,4,2013,5761,2761,3000,413,0,0,606
VYS,4,2013,2518,1254,1264,246,0,0,150
VYS,4,2013,7113,3603,3510,478,0,0,580
VYS,4,2013,6203,3057,3146,504,0,0,500
JHM,4,2013,5309,2611,2698,428,0,0,396
JHM,4,2013,21292,10556,10736,1656,0,0,1103
JHM,4,2013,9133,4545,4588,877,0,0,685
JHM,4,2013,6541,3028,3513,512,0,0,492
JHM,4,2013,11784,5240,6544,746,0,0,740
JHM,4,2013,4288,2001,2287,378,0,0,324
JHM,4,2013,7926,3944,3982,457,0,0,555
OLK,4,2013,3503,1561,1942,230,0,0,223
OLK,4,2013,14208,6660,7548,1152,0,0,1067
OLK,4,2013,6182,3280,2902,532,0,0,508
OLK,4,2013,8914,4307,4607,586,0,0,612
OLK,4,2013,8424,3976,4448,601,0,0,545
ZLK,4,2013,6691,3066,3625,513,0,0,514
ZLK,4,2013,7405,3527,3878,541,0,0,331
ZLK,4,2013,9567,4138,5429,726,0,0,576
ZLK,4,2013,9478,4659,4819,931,0,0,636
MSK,4,2013,9037,4251,4786,550,0,0,447
MSK,4,2013,10664,5016,5648,950,0,0,831
MSK,4,2013,21754,10512,11242,1379,0,0,1122
MSK,4,2013,8416,3836,4580,760,0,0,581
MSK,4,2013,10221,4632,5589,800,0,0,689
MSK,4,2013,24910,11461,13449,1806,0,0,1426
PHA,5,2013,40893,19734,21159,3629,0,0,1251
STC,5,2013,3208,1542,1666,325,0,0,199
STC,5,2013,3743,1892,1851,330,0,0,210
STC,5,2013,8799,4269,4530,538,0,0,424
STC,5,2013,5520,2770,2750,439,0,0,261
STC,5,2013,3967,2011,1956,313,0,0,163
STC,5,2013,5466,2724,2742,414,0,0,342
STC,5,2013,3962,2117,1845,341,0,0,205
STC,5,2013,4969,2464,2505,365,0,0,245
STC,5,2013,3644,1806,1838,498,0,0,238
STC,5,2013,3422,1698,1724,313,0,0,88
STC,5,2013,6450,3082,3368,485,0,0,347
STC,5,2013,2825,1467,1358,213,0,0,176
JHC,5,2013,7119,3632,3487,658,0,0,644
JHC,5,2013,3604,1772,1832,292,0,0,181
JHC,5,2013,3700,1939,1761,292,0,0,222
JHC,5,2013,2793,1411,1382,303,0,0,206
JHC,5,2013,1800,841,959,205,0,0,106
JHC,5,2013,3558,1866,1692,248,0,0,175
JHC,5,2013,4923,2546,2377,385,0,0,320
PLK,5,2013,2689,1394,1295,204,0,0,152
PLK,5,2013,3673,1846,1827,313,0,0,244
PLK,5,2013,7898,4023,3875,791,0,0,502
PLK,5,2013,2097,1070,1027,226,0,0,141
PLK,5,2013,2938,1549,1389,306,0,0,146
PLK,5,2013,1726,945,781,194,0,0,110
PLK,5,2013,3117,1536,1581,254,0,0,172
KVK,5,2013,4707,2077,2630,354,0,0,307
KVK,5,2013,7076,3157,3919,546,0,0,363
KVK,5,2013,6862,3250,3612,437,0,0,387
ULK,5,2013,9849,4756,5093,539,0,0,595
ULK,5,2013,10349,5303,5046,716,0,0,527
ULK,5,2013,7162,3457,3705,509,0,0,407
ULK,5,2013,6611,3294,3317,409,0,0,401
ULK,5,2013,10755,5492,5263,638,0,0,813
ULK,5,2013,9137,4531,4606,525,0,0,430
ULK,5,2013,9916,4522,5394,555,0,0,367
LBK,5,2013,6660,3500,3160,471,0,0,436
LBK,5,2013,4588,2352,2236,344,0,0,316
LBK,5,2013,9585,4838,4747,783,0,0,443
LBK,5,2013,4000,2042,1958,265,0,0,303
HKK,5,2013,7317,3511,3806,506,0,0,393
HKK,5,2013,3095,1578,1517,274,0,0,246
HKK,5,2013,4721,2270,2451,454,0,0,318
HKK,5,2013,3215,1714,1501,288,0,0,193
HKK,5,2013,6728,3241,3487,525,0,0,394
PAK,5,2013,5008,2525,2483,417,0,0,385
PAK,5,2013,6792,3399,3393,641,0,0,456
PAK,5,2013,5698,2767,2931,374,0,0,437
PAK,5,2013,6635,3221,3414,502,0,0,468
VYS,5,2013,4276,2268,2008,319,0,0,315
VYS,5,2013,5409,2684,2725,365,0,0,566
VYS,5,2013,2255,1170,1085,203,0,0,132
VYS,5,2013,6726,3513,3213,418,0,0,544
VYS,5,2013,5841,3025,2816,370,0,0,478
JHM,5,2013,5116,2540,2576,379,0,0,382
JHM,5,2013,21212,10584,10628,1477,0,0,1087
JHM,5,2013,8914,4537,4377,754,0,0,641
JHM,5,2013,6189,2914,3275,451,0,0,459
JHM,5,2013,11350,5209,6141,660,0,0,734
JHM,5,2013,4067,1951,2116,321,0,0,291
JHM,5,2013,7302,3727,3575,375,0,0,531
OLK,5,2013,3137,1484,1653,240,0,0,209
OLK,5,2013,13702,6574,7128,914,0,0,1035
OLK,5,2013,5826,3163,2663,432,0,0,424
OLK,5,2013,8590,4270,4320,487,0,0,598
OLK,5,2013,8010,3926,4084,537,0,0,502
ZLK,5,2013,6347,2993,3354,404,0,0,481
ZLK,5,2013,7097,3519,3578,528,0,0,309
ZLK,5,2013,8987,4023,4964,600,0,0,537
ZLK,5,2013,9023,4571,4452,699,0,0,613
MSK,5,2013,8598,4130,4468,536,0,0,450
MSK,5,2013,10285,4989,5296,803,0,0,761
MSK,5,2013,21658,10536,11122,1219,0,0,1071
MSK,5,2013,8034,3780,4254,719,0,0,540
MSK,5,2013,9716,4580,5136,704,0,0,676
MSK,5,2013,24827,11530,13297,1637,0,0,1387
PHA,6,2013,41690,20196,21494,3558,0,0,1172
STC,6,2013,3147,1566,1581,306,0,0,175
STC,6,2013,3749,1911,1838,292,0,0,178
STC,6,2013,8723,4262,4461,413,0,0,344
STC,6,2013,5413,2758,2655,426,0,0,222
STC,6,2013,3860,2016,1844,301,0,0,147
STC,6,2013,5419,2700,2719,368,0,0,275
STC,6,2013,3880,2117,1763,306,0,0,162
STC,6,2013,4959,2512,2447,390,0,0,219
STC,6,2013,3601,1826,1775,392,0,0,205
STC,6,2013,3440,1746,1694,238,0,0,71
STC,6,2013,6434,3104,3330,478,0,0,313
STC,6,2013,2774,1453,1321,204,0,0,138
JHC,6,2013,7026,3634,3392,641,0,0,523
JHC,6,2013,3609,1770,1839,365,0,0,162
JHC,6,2013,3481,1852,1629,271,0,0,185
JHC,6,2013,2636,1389,1247,247,0,0,155
JHC,6,2013,1712,820,892,175,0,0,77
JHC,6,2013,3486,1844,1642,233,0,0,144
JHC,6,2013,4799,2537,2262,338,0,0,267
PLK,6,2013,2579,1374,1205,189,0,0,100
PLK,6,2013,3539,1826,1713,266,0,0,197
PLK,6,2013,7689,3981,3708,613,0,0,397
PLK,6,2013,2100,1090,1010,206,0,0,109
PLK,6,2013,2896,1549,1347,260,0,0,131
PLK,6,2013,1698,936,762,165,0,0,90
PLK,6,2013,3079,1529,1550,249,0,0,153
KVK,6,2013,4710,2099,2611,448,0,0,284
KVK,6,2013,7041,3162,3879,519,0,0,287
KVK,6,2013,6763,3257,3506,393,0,0,324
ULK,6,2013,9595,4703,4892,627,0,0,450
ULK,6,2013,10260,5281,4979,695,0,0,445
ULK,6,2013,7033,3429,3604,586,0,0,341
ULK,6,2013,6515,3276,3239,388,0,0,332
ULK,6,2013,10708,5499,5209,574,0,0,687
ULK,6,2013,9023,4509,4514,508,0,0,359
ULK,6,2013,9904,4564,5340,528,0,0,294
LBK,6,2013,6383,3391,2992,390,0,0,342
LBK,6,2013,4561,2371,2190,349,0,0,255
LBK,6,2013,9491,4881,4610,702,0,0,402
LBK,6,2013,3955,2049,1906,290,0,0,235
HKK,6,2013,7331,3588,3743,520,0,0,314
HKK,6,2013,2976,1542,1434,209,0,0,199
HKK,6,2013,4552,2228,2324,350,0,0,262
HKK,6,2013,3096,1680,1416,242,0,0,165
HKK,6,2013,6643,3243,3400,482,0,0,340
PAK,6,2013,4852,2499,2353,382,0,0,321
PAK,6,2013,6644,3400,3244,521,0,0,410
PAK,6,2013,5472,2713,2759,340,0,0,335
PAK,6,2013,6344,3165,3179,435,0,0,366
VYS,6,2013,4160,2231,1929,265,0,0,259
VYS,6,2013,5359,2702,2657,406,0,0,441
VYS,6,2013,2219,1170,1049,252,0,0,119
VYS,6,2013,6715,3557,3158,462,0,0,414
VYS,6,2013,5736,3013,2723,391,0,0,395
JHM,6,2013,5035,2558,2477,354,0,0,293
JHM,6,2013,21369,10766,10603,1531,0,0,994
JHM,6,2013,8881,4606,4275,693,0,0,509
JHM,6,2013,6025,2854,3171,392,0,0,372
JHM,6,2013,11075,5163,5912,651,0,0,583
JHM,6,2013,3993,1981,2012,337,0,0,232
JHM,6,2013,7049,3633,3416,399,0,0,413
OLK,6,2013,2966,1428,1538,199,0,0,161
OLK,6,2013,13369,6543,6826,900,0,0,806
OLK,6,2013,5714,3141,2573,442,0,0,331
OLK,6,2013,8447,4258,4189,478,0,0,502
OLK,6,2013,7827,3864,3963,522,0,0,384
ZLK,6,2013,6267,3049,3218,421,0,0,368
ZLK,6,2013,6904,3499,3405,451,0,0,286
ZLK,6,2013,8659,3982,4677,560,0,0,433
ZLK,6,2013,8878,4595,4283,717,0,0,502
MSK,6,2013,8498,4150,4348,475,0,0,373
MSK,6,2013,10150,4981,5169,827,0,0,648
MSK,6,2013,21601,10564,11037,1149,0,0,885
MSK,6,2013,7884,3795,4089,665,0,0,428
MSK,6,2013,9659,4679,4980,729,0,0,562
MSK,6,2013,24764,11579,13185,1498,0,0,1143
PHA,7,2013,43529,21653,21876,4747,0,0,1273
STC,7,2013,3303,1685,1618,475,0,0,201
STC,7,2013,3891,2023,1868,425,0,0,186
STC,7,2013,8957,4460,4497,620,0,0,363
STC,7,2013,5498,2874,2624,550,0,0,222
STC,7,2013,3952,2134,1818,435,0,0,172
STC,7,2013,5559,2853,2706,529,0,0,288
STC,7,2013,4008,2226,1782,440,0,0,174
STC,7,2013,5110,2658,2452,468,0,0,241
STC,7,2013,3743,1948,1795,584,0,0,223
STC,7,2013,3711,1934,1777,503,0,0,77
STC,7,2013,6631,3276,3355,654,0,0,354
STC,7,2013,2827,1501,1326,273,0,0,144
JHC,7,2013,7209,3768,3441,786,0,0,564
JHC,7,2013,3653,1828,1825,345,0,0,182
JHC,7,2013,3520,1958,1562,428,0,0,204
JHC,7,2013,2740,1498,1242,387,0,0,166
JHC,7,2013,1738,866,872,252,0,0,87
JHC,7,2013,3574,1950,1624,381,0,0,155
JHC,7,2013,4912,2650,2262,521,0,0,304
PLK,7,2013,2602,1421,1181,236,0,0,101
PLK,7,2013,3640,1899,1741,385,0,0,227
PLK,7,2013,7891,4187,3704,810,0,0,467
PLK,7,2013,2139,1137,1002,245,0,0,110
PLK,7,2013,2944,1621,1323,346,0,0,160
PLK,7,2013,1714,971,743,214,0,0,103
PLK,7,2013,3081,1532,1549,310,0,0,168
KVK,7,2013,4669,2160,2509,467,0,0,276
KVK,7,2013,7099,3256,3843,652,0,0,330
KVK,7,2013,6773,3308,3465,504,0,0,319
ULK,7,2013,9659,4840,4819,817,0,0,473
ULK,7,2013,10263,5350,4913,918,0,0,449
ULK,7,2013,7110,3540,3570,748,0,0,340
ULK,7,2013,6579,3386,3193,542,0,0,352
ULK,7,2013,10833,5634,5199,766,0,0,691
ULK,7,2013,8972,4533,4439,587,0,0,367
ULK,7,2013,9976,4646,5330,626,0,0,282
LBK,7,2013,6400,3456,2944,527,0,0,357
LBK,7,2013,4681,2453,2228,469,0,0,296
LBK,7,2013,9794,5147,4647,958,0,0,452
LBK,7,2013,4040,2128,1912,371,0,0,260
HKK,7,2013,7493,3788,3705,653,0,0,334
HKK,7,2013,3110,1648,1462,363,0,0,194
HKK,7,2013,4683,2343,2340,543,0,0,297
HKK,7,2013,3158,1758,1400,369,0,0,180
HKK,7,2013,6777,3405,3372,655,0,0,334
PAK,7,2013,5035,2679,2356,605,0,0,366
PAK,7,2013,6716,3525,3191,684,0,0,436
PAK,7,2013,5584,2859,2725,569,0,0,376
PAK,7,2013,6398,3293,3105,634,0,0,399
VYS,7,2013,4274,2352,1922,437,0,0,282
VYS,7,2013,5458,2846,2612,596,0,0,482
VYS,7,2013,2299,1276,1023,340,0,0,159
VYS,7,2013,6904,3766,3138,611,0,0,489
VYS,7,2013,5928,3192,2736,622,0,0,459
JHM,7,2013,5185,2705,2480,532,0,0,333
JHM,7,2013,21824,11186,10638,2001,0,0,1006
JHM,7,2013,9199,4904,4295,1079,0,0,565
JHM,7,2013,6065,2955,3110,608,0,0,406
JHM,7,2013,11304,5349,5955,1050,0,0,638
JHM,7,2013,4134,2134,2000,511,0,0,259
JHM,7,2013,7102,3762,3340,581,0,0,423
OLK,7,2013,2848,1411,1437,226,0,0,165
OLK,7,2013,13677,6805,6872,1328,0,0,842
OLK,7,2013,5796,3250,2546,519,0,0,358
OLK,7,2013,8600,4397,4203,626,0,0,572
OLK,7,2013,7912,4002,3910,712,0,0,452
ZLK,7,2013,6345,3142,3203,580,0,0,414
ZLK,7,2013,6961,3643,3318,646,0,0,319
ZLK,7,2013,8675,4089,4586,754,0,0,501
ZLK,7,2013,9002,4755,4247,982,0,0,543
MSK,7,2013,8491,4236,4255,565,0,0,374
MSK,7,2013,10337,5235,5102,1138,0,0,745
MSK,7,2013,21938,10800,11138,1646,0,0,947
MSK,7,2013,7964,3953,4011,889,0,0,486
MSK,7,2013,9724,4877,4847,912,0,0,629
MSK,7,2013,25272,12054,13218,1996,0,0,1218
PHA,8,2013,44032,21953,22079,3580,0,0,1387
STC,8,2013,3321,1682,1639,372,0,0,210
STC,8,2013,3930,2052,1878,301,0,0,195
STC,8,2013,8972,4463,4509,463,0,0,399
STC,8,2013,5457,2874,2583,431,0,0,234
STC,8,2013,3985,2160,1825,350,0,0,193
STC,8,2013,5550,2850,2700,437,0,0,300
STC,8,2013,4074,2247,1827,400,0,0,198
STC,8,2013,5093,2665,2428,320,0,0,258
STC,8,2013,3748,1991,1757,498,0,0,220
STC,8,2013,3772,1987,1785,339,0,0,79
STC,8,2013,6665,3310,3355,472,0,0,377
STC,8,2013,2810,1509,1301,229,0,0,160
JHC,8,2013,7122,3732,3390,703,0,0,577
JHC,8,2013,3659,1825,1834,294,0,0,184
JHC,8,2013,3480,1923,1557,342,0,0,222
JHC,8,2013,2728,1520,1208,263,0,0,181
JHC,8,2013,1694,855,839,179,0,0,83
JHC,8,2013,3589,1941,1648,299,0,0,198
JHC,8,2013,4840,2632,2208,430,0,0,306
PLK,8,2013,2585,1434,1151,194,0,0,126
PLK,8,2013,3579,1880,1699,290,0,0,228
PLK,8,2013,8073,4294,3779,731,0,0,521
PLK,8,2013,2227,1193,1034,248,0,0,147
PLK,8,2013,2944,1641,1303,334,0,0,167
PLK,8,2013,1707,980,727,170,0,0,113
PLK,8,2013,3088,1569,1519,241,0,0,187
KVK,8,2013,4720,2199,2521,400,0,0,298
KVK,8,2013,7097,3297,3800,534,0,0,366
KVK,8,2013,6782,3334,3448,482,0,0,362
ULK,8,2013,9603,4852,4751,631,0,0,476
ULK,8,2013,10384,5426,4958,713,0,0,493
ULK,8,2013,7038,3525,3513,539,0,0,347
ULK,8,2013,6539,3400,3139,442,0,0,366
ULK,8,2013,10793,5649,5144,635,0,0,688
ULK,8,2013,8907,4527,4380,568,0,0,382
ULK,8,2013,9962,4673,5289,522,0,0,281
LBK,8,2013,6355,3424,2931,473,0,0,389
LBK,8,2013,4673,2433,2240,356,0,0,321
LBK,8,2013,9715,5109,4606,722,0,0,468
LBK,8,2013,4009,2130,1879,269,0,0,275
HKK,8,2013,7581,3844,3737,501,0,0,375
HKK,8,2013,3065,1635,1430,254,0,0,202
HKK,8,2013,4656,2351,2305,427,0,0,323
HKK,8,2013,3101,1745,1356,278,0,0,227
HKK,8,2013,6733,3400,3333,484,0,0,341
PAK,8,2013,5013,2694,2319,449,0,0,422
PAK,8,2013,6746,3598,3148,523,0,0,455
PAK,8,2013,5610,2885,2725,400,0,0,405
PAK,8,2013,6305,3294,3011,495,0,0,433
VYS,8,2013,4261,2358,1903,304,0,0,331
VYS,8,2013,5458,2887,2571,415,0,0,535
VYS,8,2013,2295,1279,1016,243,0,0,193
VYS,8,2013,6895,3796,3099,466,0,0,565
VYS,8,2013,5961,3225,2736,466,0,0,521
JHM,8,2013,5175,2719,2456,418,0,0,391
JHM,8,2013,21921,11251,10670,1592,0,0,1078
JHM,8,2013,9313,4979,4334,838,0,0,656
JHM,8,2013,6033,2928,3105,497,0,0,424
JHM,8,2013,11320,5399,5921,860,0,0,710
JHM,8,2013,4124,2131,1993,392,0,0,304
JHM,8,2013,7144,3805,3339,418,0,0,471
OLK,8,2013,2808,1413,1395,151,0,0,173
OLK,8,2013,13638,6789,6849,948,0,0,922
OLK,8,2013,5803,3275,2528,471,0,0,399
OLK,8,2013,8626,4428,4198,493,0,0,634
OLK,8,2013,7948,4031,3917,553,0,0,526
ZLK,8,2013,6302,3145,3157,503,0,0,429
ZLK,8,2013,7007,3703,3304,557,0,0,419
ZLK,8,2013,8660,4111,4549,650,0,0,606
ZLK,8,2013,9074,4775,4299,805,0,0,653
MSK,8,2013,8405,4211,4194,428,0,0,415
MSK,8,2013,10335,5249,5086,919,0,0,835
MSK,8,2013,22023,10901,11122,1348,0,0,1064
MSK,8,2013,7981,3979,4002,705,0,0,545
MSK,8,2013,9736,4857,4879,767,0,0,678
MSK,8,2013,25374,12171,13203,1620,0,0,1289
PHA,9,2013,44508,22085,22423,5154,0,0,1779
STC,9,2013,3454,1746,1708,618,0,0,326
STC,9,2013,3957,2068,1889,459,0,0,265
STC,9,2013,8938,4444,4494,673,0,0,526
STC,9,2013,5661,2964,2697,755,0,0,360
STC,9,2013,4031,2156,1875,512,0,0,233
STC,9,2013,5678,2905,2773,673,0,0,414
STC,9,2013,4115,2280,1835,565,0,0,275
STC,9,2013,5158,2686,2472,580,0,0,286
STC,9,2013,3844,2029,1815,724,0,0,299
STC,9,2013,3798,1992,1806,537,0,0,117
STC,9,2013,6747,3314,3433,720,0,0,491
STC,9,2013,2901,1556,1345,410,0,0,239
JHC,9,2013,7078,3698,3380,1007,0,0,656
JHC,9,2013,3781,1911,1870,497,0,0,225
JHC,9,2013,3598,1980,1618,527,0,0,318
JHC,9,2013,2787,1537,1250,450,0,0,233
JHC,9,2013,1682,847,835,272,0,0,93
JHC,9,2013,3571,1902,1669,423,0,0,245
JHC,9,2013,4889,2630,2259,633,0,0,394
PLK,9,2013,2588,1409,1179,288,0,0,190
PLK,9,2013,3661,1933,1728,527,0,0,313
PLK,9,2013,8091,4277,3814,1067,0,0,585
PLK,9,2013,2243,1191,1052,338,0,0,190
PLK,9,2013,3058,1661,1397,509,0,0,251
PLK,9,2013,1781,1006,775,311,0,0,138
PLK,9,2013,3029,1518,1511,345,0,0,218
KVK,9,2013,4672,2137,2535,538,0,0,331
KVK,9,2013,7236,3308,3928,816,0,0,529
KVK,9,2013,6900,3386,3514,686,0,0,509
ULK,9,2013,9725,4867,4858,1015,0,0,651
ULK,9,2013,10407,5387,5020,1063,0,0,615
ULK,9,2013,7284,3630,3654,971,0,0,569
ULK,9,2013,6579,3411,3168,670,0,0,467
ULK,9,2013,10841,5657,5184,933,0,0,815
ULK,9,2013,9098,4589,4509,853,0,0,508
ULK,9,2013,10085,4724,5361,852,0,0,325
LBK,9,2013,6443,3453,2990,707,0,0,461
LBK,9,2013,4764,2466,2298,642,0,0,388
LBK,9,2013,9629,5049,4580,1066,0,0,636
LBK,9,2013,4069,2156,1913,488,0,0,372
HKK,9,2013,7677,3858,3819,869,0,0,459
HKK,9,2013,3074,1638,1436,417,0,0,294
HKK,9,2013,4753,2405,2348,730,0,0,403
HKK,9,2013,3106,1744,1362,452,0,0,288
HKK,9,2013,6822,3438,3384,833,0,0,486
PAK,9,2013,4999,2658,2341,663,0,0,544
PAK,9,2013,6580,3464,3116,684,0,0,525
PAK,9,2013,5604,2831,2773,706,0,0,548
PAK,9,2013,6327,3276,3051,734,0,0,578
VYS,9,2013,4094,2205,1889,477,0,0,383
VYS,9,2013,5215,2699,2516,632,0,0,573
VYS,9,2013,2278,1248,1030,355,0,0,218
VYS,9,2013,6917,3796,3121,679,0,0,718
VYS,9,2013,5996,3221,2775,704,0,0,675
JHM,9,2013,5275,2730,2545,761,0,0,539
JHM,9,2013,22030,11249,10781,2250,0,0,1276
JHM,9,2013,9435,5010,4425,1327,0,0,914
JHM,9,2013,6205,3030,3175,889,0,0,624
JHM,9,2013,11387,5401,5986,1260,0,0,939
JHM,9,2013,4217,2164,2053,644,0,0,427
JHM,9,2013,7178,3811,3367,785,0,0,649
OLK,9,2013,2832,1406,1426,321,0,0,238
OLK,9,2013,13757,6766,6991,1656,0,0,1193
OLK,9,2013,5953,3350,2603,743,0,0,515
OLK,9,2013,8779,4505,4274,878,0,0,807
OLK,9,2013,7992,4027,3965,909,0,0,644
ZLK,9,2013,6397,3170,3227,720,0,0,570
ZLK,9,2013,7085,3695,3390,854,0,0,653
ZLK,9,2013,8615,4034,4581,965,0,0,737
ZLK,9,2013,9140,4788,4352,1240,0,0,871
MSK,9,2013,8534,4286,4248,810,0,0,568
MSK,9,2013,10528,5296,5232,1442,0,0,1061
MSK,9,2013,22358,11022,11336,2031,0,0,1368
MSK,9,2013,8039,4007,4032,1054,0,0,687
MSK,9,2013,10005,5004,5001,1365,0,0,863
MSK,9,2013,25516,12209,13307,2407,0,0,1511
PHA,10,2013,44785,22229,22556,4320,0,0,1892
STC,10,2013,3416,1733,1683,392,0,0,292
STC,10,2013,3914,2051,1863,328,0,0,280
STC,10,2013,8993,4437,4556,550,0,0,574
STC,10,2013,5594,2932,2662,461,0,0,360
STC,10,2013,4044,2160,1884,362,0,0,245
STC,10,2013,5739,2950,2789,478,0,0,456
STC,10,2013,4011,2234,1777,389,0,0,250
STC,10,2013,5261,2713,2548,419,0,0,343
STC,10,2013,3836,1991,1845,528,0,0,305
STC,10,2013,3894,2026,1868,413,0,0,155
STC,10,2013,6799,3323,3476,567,0,0,492
STC,10,2013,2866,1529,1337,248,0,0,232
JHC,10,2013,7299,3784,3515,861,0,0,690
JHC,10,2013,3787,1917,1870,378,0,0,243
JHC,10,2013,3706,2037,1669,473,0,0,312
JHC,10,2013,2753,1533,1220,303,0,0,235
JHC,10,2013,1683,851,832,202,0,0,117
JHC,10,2013,3545,1882,1663,301,0,0,253
JHC,10,2013,4959,2662,2297,437,0,0,395
PLK,10,2013,2608,1404,1204,215,0,0,188
PLK,10,2013,3656,1922,1734,394,0,0,297
PLK,10,2013,7936,4214,3722,727,0,0,598
PLK,10,2013,2258,1187,1071,222,0,0,186
PLK,10,2013,3008,1635,1373,290,0,0,238
PLK,10,2013,1763,1012,751,228,0,0,137
PLK,10,2013,2953,1461,1492,255,0,0,190
KVK,10,2013,4657,2155,2502,445,0,0,344
KVK,10,2013,7228,3274,3954,601,0,0,526
KVK,10,2013,6932,3425,3507,455,0,0,524
ULK,10,2013,9678,4853,4825,654,0,0,652
ULK,10,2013,10407,5357,5050,787,0,0,633
ULK,10,2013,7408,3704,3704,633,0,0,590
ULK,10,2013,6572,3392,3180,518,0,0,461
ULK,10,2013,10753,5622,5131,707,0,0,837
ULK,10,2013,9252,4627,4625,660,0,0,528
ULK,10,2013,10172,4746,5426,624,0,0,455
LBK,10,2013,6330,3424,2906,523,0,0,454
LBK,10,2013,4687,2459,2228,421,0,0,383
LBK,10,2013,9637,5050,4587,809,0,0,588
LBK,10,2013,4079,2161,1918,345,0,0,371
HKK,10,2013,7717,3883,3834,574,0,0,503
HKK,10,2013,3086,1637,1449,313,0,0,307
HKK,10,2013,4761,2407,2354,530,0,0,402
HKK,10,2013,2995,1671,1324,312,0,0,285
HKK,10,2013,6956,3506,3450,599,0,0,521
PAK,10,2013,5028,2653,2375,488,0,0,513
PAK,10,2013,6766,3571,3195,642,0,0,587
PAK,10,2013,5581,2847,2734,453,0,0,525
PAK,10,2013,6187,3191,2996,477,0,0,552
VYS,10,2013,4107,2167,1940,373,0,0,366
VYS,10,2013,5140,2627,2513,427,0,0,571
VYS,10,2013,2235,1218,1017,251,0,0,210
VYS,10,2013,7017,3865,3152,549,0,0,703
VYS,10,2013,5970,3187,2783,421,0,0,655
JHM,10,2013,5195,2702,2493,390,0,0,522
JHM,10,2013,21919,11166,10753,1666,0,0,1253
JHM,10,2013,9296,4938,4358,797,0,0,898
JHM,10,2013,6126,2981,3145,526,0,0,589
JHM,10,2013,11277,5350,5927,774,0,0,933
JHM,10,2013,4203,2141,2062,426,0,0,414
JHM,10,2013,7309,3860,3449,571,0,0,677
OLK,10,2013,2906,1436,1470,309,0,0,249
OLK,10,2013,13668,6652,7016,1096,0,0,1205
OLK,10,2013,5955,3340,2615,500,0,0,497
OLK,10,2013,8752,4509,4243,609,0,0,781
OLK,10,2013,8066,4017,4049,710,0,0,652
ZLK,10,2013,6388,3169,3219,497,0,0,562
ZLK,10,2013,6973,3634,3339,539,0,0,605
ZLK,10,2013,8582,4026,4556,705,0,0,713
ZLK,10,2013,9082,4719,4363,813,0,0,881
MSK,10,2013,8609,4346,4263,531,0,0,587
MSK,10,2013,10568,5306,5262,975,0,0,1059
MSK,10,2013,22212,10909,11303,1379,0,0,1339
MSK,10,2013,7870,3926,3944,764,0,0,664
MSK,10,2013,9856,4948,4908,750,0,0,857
MSK,10,2013,25465,12130,13335,1684,0,0,1515
PHA,11,2013,44664,22109,22555,3618,0,0,1869
STC,11,2013,3458,1728,1730,430,0,0,277
STC,11,2013,3922,2053,1869,356,0,0,273
STC,11,2013,9038,4411,4627,591,0,0,562
STC,11,2013,5857,3025,2832,668,0,0,349
STC,11,2013,4128,2218,1910,438,0,0,230
STC,11,2013,5767,2954,2813,465,0,0,420
STC,11,2013,3979,2199,1780,369,0,0,237
STC,11,2013,5258,2666,2592,438,0,0,327
STC,11,2013,3875,1999,1876,531,0,0,286
STC,11,2013,3797,1944,1853,323,0,0,143
STC,11,2013,6945,3319,3626,660,0,0,456
STC,11,2013,2888,1522,1366,264,0,0,219
JHC,11,2013,7463,3863,3600,809,0,0,690
JHC,11,2013,3902,2000,1902,433,0,0,241
JHC,11,2013,3956,2153,1803,547,0,0,303
JHC,11,2013,2868,1547,1321,410,0,0,222
JHC,11,2013,1823,906,917,298,0,0,131
JHC,11,2013,3661,1890,1771,383,0,0,239
JHC,11,2013,5098,2705,2393,512,0,0,373
PLK,11,2013,2585,1365,1220,222,0,0,167
PLK,11,2013,3826,2008,1818,492,0,0,286
PLK,11,2013,7925,4184,3741,760,0,0,591
PLK,11,2013,2257,1169,1088,242,0,0,164
PLK,11,2013,3014,1629,1385,314,0,0,223
PLK,11,2013,1770,1019,751,209,0,0,129
PLK,11,2013,2919,1439,1480,223,0,0,170
KVK,11,2013,4766,2206,2560,558,0,0,289
KVK,11,2013,7301,3260,4041,596,0,0,477
KVK,11,2013,6983,3433,3550,519,0,0,487
ULK,11,2013,9894,4892,5002,806,0,0,642
ULK,11,2013,10410,5354,5056,744,0,0,612
ULK,11,2013,7512,3739,3773,678,0,0,558
ULK,11,2013,6550,3337,3213,492,0,0,433
ULK,11,2013,10637,5536,5101,580,0,0,803
ULK,11,2013,9175,4583,4592,645,0,0,535
ULK,11,2013,10316,4774,5542,628,0,0,481
LBK,11,2013,6430,3454,2976,587,0,0,447
LBK,11,2013,4745,2437,2308,413,0,0,363
LBK,11,2013,9641,5028,4613,792,0,0,564
LBK,11,2013,4208,2187,2021,450,0,0,360
HKK,11,2013,7797,3873,3924,579,0,0,544
HKK,11,2013,3175,1651,1524,367,0,0,292
HKK,11,2013,4892,2412,2480,549,0,0,379
HKK,11,2013,2998,1679,1319,341,0,0,268
HKK,11,2013,7065,3487,3578,660,0,0,485
PAK,11,2013,5245,2709,2536,655,0,0,510
PAK,11,2013,6778,3558,3220,615,0,0,565
PAK,11,2013,5815,2923,2892,620,0,0,510
PAK,11,2013,6203,3144,3059,564,0,0,525
VYS,11,2013,4236,2229,2007,448,0,0,348
VYS,11,2013,5254,2659,2595,528,0,0,547
VYS,11,2013,2373,1250,1123,347,0,0,215
VYS,11,2013,7264,3938,3326,702,0,0,646
VYS,11,2013,6113,3210,2903,553,0,0,627
JHM,11,2013,5303,2726,2577,493,0,0,501
JHM,11,2013,22115,11247,10868,1623,0,0,1255
JHM,11,2013,9560,4970,4590,985,0,0,885
JHM,11,2013,6504,3107,3397,844,0,0,582
JHM,11,2013,11648,5379,6269,1097,0,0,907
JHM,11,2013,4257,2140,2117,416,0,0,388
JHM,11,2013,7950,4167,3783,998,0,0,668
OLK,11,2013,3161,1534,1627,443,0,0,236
OLK,11,2013,13912,6730,7182,1288,0,0,1134
OLK,11,2013,6014,3310,2704,617,0,0,480
OLK,11,2013,8881,4466,4415,697,0,0,739
OLK,11,2013,8260,4054,4206,798,0,0,631
ZLK,11,2013,6497,3190,3307,536,0,0,534
ZLK,11,2013,7123,3682,3441,631,0,0,574
ZLK,11,2013,8684,4042,4642,752,0,0,667
ZLK,11,2013,9215,4711,4504,961,0,0,838
MSK,11,2013,8937,4492,4445,708,0,0,602
MSK,11,2013,10729,5304,5425,1013,0,0,1014
MSK,11,2013,22368,10943,11425,1457,0,0,1316
MSK,11,2013,8027,3938,4089,868,0,0,619
MSK,11,2013,10093,4949,5144,917,0,0,844
MSK,11,2013,25656,12153,13503,1672,0,0,1476
PHA,12,2013,44922,22238,22684,2882,0,0,1846
STC,12,2013,3690,1787,1903,490,0,0,280
STC,12,2013,4076,2097,1979,369,0,0,273
STC,12,2013,9233,4485,4748,455,0,0,565
STC,12,2013,6231,3137,3094,654,0,0,343
STC,12,2013,4457,2300,2157,540,0,0,226
STC,12,2013,5956,2999,2957,483,0,0,406
STC,12,2013,4037,2211,1826,360,0,0,238
STC,12,2013,5538,2766,2772,515,0,0,322
STC,12,2013,4006,2040,1966,457,0,0,285
STC,12,2013,3940,2003,1937,317,0,0,144
STC,12,2013,7460,3403,4057,757,0,0,440
STC,12,2013,3057,1568,1489,314,0,0,220
JHC,12,2013,7782,3870,3912,787,0,0,667
JHC,12,2013,4156,2001,2155,471,0,0,235
JHC,12,2013,4724,2313,2411,951,0,0,322
JHC,12,2013,3211,1608,1603,544,0,0,209
JHC,12,2013,2202,950,1252,479,0,0,145
JHC,12,2013,3967,1928,2039,508,0,0,224
JHC,12,2013,5509,2769,2740,642,0,0,379
PLK,12,2013,2705,1360,1345,285,0,0,158
PLK,12,2013,4305,2071,2234,728,0,0,275
PLK,12,2013,7984,4178,3806,616,0,0,562
PLK,12,2013,2395,1196,1199,279,0,0,166
PLK,12,2013,3222,1681,1541,403,0,0,213
PLK,12,2013,1888,1064,824,234,0,0,126
PLK,12,2013,3210,1507,1703,437,0,0,168
KVK,12,2013,4925,2253,2672,482,0,0,262
KVK,12,2013,7530,3339,4191,628,0,0,459
KVK,12,2013,7145,3461,3684,474,0,0,480
ULK,12,2013,10264,4965,5299,831,0,0,629
ULK,12,2013,10596,5363,5233,665,0,0,602
ULK,12,2013,7926,3884,4042,796,0,0,539
ULK,12,2013,6811,3362,3449,567,0,0,432
ULK,12,2013,10724,5603,5121,543,0,0,789
ULK,12,2013,9161,4559,4602,538,0,0,519
ULK,12,2013,10338,4761,5577,470,0,0,489
LBK,12,2013,6709,3547,3162,633,0,0,436
LBK,12,2013,4867,2459,2408,411,0,0,347
LBK,12,2013,9953,5105,4848,779,0,0,537
LBK,12,2013,4380,2175,2205,473,0,0,354
HKK,12,2013,8268,3923,4345,771,0,0,535
HKK,12,2013,3483,1687,1796,489,0,0,288
HKK,12,2013,5329,2466,2863,748,0,0,377
HKK,12,2013,3274,1725,1549,500,0,0,258
HKK,12,2013,7324,3424,3900,745,0,0,468
PAK,12,2013,6037,2785,3252,1089,0,0,513
PAK,12,2013,7090,3586,3504,678,0,0,549
PAK,12,2013,6623,3116,3507,1039,0,0,517
PAK,12,2013,6621,3187,3434,691,0,0,520
VYS,12,2013,4756,2357,2399,743,0,0,353
VYS,12,2013,5778,2723,3055,748,0,0,551
VYS,12,2013,2778,1343,1435,574,0,0,220
VYS,12,2013,8148,4089,4059,1183,0,0,652
VYS,12,2013,6844,3287,3557,964,0,0,655
JHM,12,2013,5621,2772,2849,610,0,0,478
JHM,12,2013,22574,11355,11219,1421,0,0,1237
JHM,12,2013,10032,5076,4956,992,0,0,870
JHM,12,2013,7322,3293,4029,1070,0,0,584
JHM,12,2013,12953,5707,7246,1755,0,0,907
JHM,12,2013,4586,2209,2377,555,0,0,381
JHM,12,2013,8882,4363,4519,1152,0,0,682
OLK,12,2013,3475,1564,1911,480,0,0,226
OLK,12,2013,14778,6781,7997,1541,0,0,1116
OLK,12,2013,6455,3380,3075,741,0,0,519
OLK,12,2013,9752,4572,5180,1192,0,0,735
OLK,12,2013,8904,4089,4815,1114,0,0,622
ZLK,12,2013,6934,3213,3721,729,0,0,536
ZLK,12,2013,7710,3773,3937,942,0,0,565
ZLK,12,2013,9538,4143,5395,1209,0,0,669
ZLK,12,2013,9796,4771,5025,1149,0,0,838
MSK,12,2013,9741,4573,5168,1097,0,0,610
MSK,12,2013,11345,5384,5961,1275,0,0,975
MSK,12,2013,22811,11067,11744,1362,0,0,1268
MSK,12,2013,8672,4049,4623,1098,0,0,629
MSK,12,2013,11214,5062,6152,1511,0,0,867
MSK,12,2013,26193,12241,13952,1541,0,0,1465
PHA,1,2014,46842,23043,23799,5584,0,0,1819
STC,1,2014,4026,1871,2155,716,0,0,268
STC,1,2014,4319,2152,2167,658,0,0,260
STC,1,2014,9837,4714,5123,1372,0,0,563
STC,1,2014,6614,3232,3382,768,0,0,340
STC,1,2014,4909,2437,2472,794,0,0,216
STC,1,2014,6297,3133,3164,818,0,0,394
STC,1,2014,4213,2268,1945,642,0,0,222
STC,1,2014,5608,2775,2833,489,0,0,317
STC,1,2014,4068,2050,2018,758,0,0,264
STC,1,2014,3976,2022,1954,418,0,0,141
STC,1,2014,7869,3472,4397,921,0,0,436
STC,1,2014,3257,1606,1651,389,0,0,218
JHC,1,2014,8903,4179,4724,1837,0,0,658
JHC,1,2014,4635,2128,2507,864,0,0,214
JHC,1,2014,5269,2427,2842,997,0,0,316
JHC,1,2014,3600,1719,1881,752,0,0,203
JHC,1,2014,2516,1015,1501,488,0,0,128
JHC,1,2014,4235,1937,2298,627,0,0,213
JHC,1,2014,5935,2834,3101,857,0,0,378
PLK,1,2014,2991,1427,1564,569,0,0,195
PLK,1,2014,4730,2146,2584,937,0,0,250
PLK,1,2014,8558,4394,4164,1614,0,0,540
PLK,1,2014,2529,1196,1333,390,0,0,171
PLK,1,2014,3479,1729,1750,663,0,0,213
PLK,1,2014,1986,1079,907,325,0,0,140
PLK,1,2014,3351,1510,1841,463,0,0,160
KVK,1,2014,5338,2398,2940,1005,0,0,238
KVK,1,2014,7803,3460,4343,1039,0,0,451
KVK,1,2014,7199,3432,3767,671,0,0,494
ULK,1,2014,10945,5148,5797,1500,0,0,678
ULK,1,2014,10893,5438,5455,1198,0,0,596
ULK,1,2014,8435,4029,4406,1052,0,0,565
ULK,1,2014,7073,3429,3644,771,0,0,440
ULK,1,2014,11082,5780,5302,1070,0,0,794
ULK,1,2014,9451,4726,4725,1068,0,0,501
ULK,1,2014,10514,4830,5684,757,0,0,508
LBK,1,2014,7134,3697,3437,1009,0,0,442
LBK,1,2014,4994,2473,2521,654,0,0,355
LBK,1,2014,10455,5206,5249,1453,0,0,414
LBK,1,2014,4485,2123,2362,569,0,0,346
HKK,1,2014,8857,4076,4781,1326,0,0,515
HKK,1,2014,3774,1771,2003,590,0,0,288
HKK,1,2014,5498,2472,3026,803,0,0,400
HKK,1,2014,3474,1775,1699,607,0,0,245
HKK,1,2014,7523,3360,4163,905,0,0,466
PAK,1,2014,6530,2872,3658,1038,0,0,509
PAK,1,2014,7785,3784,4001,1570,0,0,556
PAK,1,2014,7170,3235,3935,1049,0,0,546
PAK,1,2014,7120,3235,3885,1056,0,0,525
VYS,1,2014,5053,2418,2635,811,0,0,337
VYS,1,2014,6300,2834,3466,898,0,0,549
VYS,1,2014,3024,1402,1622,519,0,0,210
VYS,1,2014,8620,4162,4458,907,0,0,655
VYS,1,2014,7211,3314,3897,838,0,0,625
JHM,1,2014,5896,2851,3045,698,0,0,469
JHM,1,2014,23296,11596,11700,2380,0,0,1173
JHM,1,2014,10159,5013,5146,999,0,0,828
JHM,1,2014,7768,3414,4354,934,0,0,558
JHM,1,2014,13504,5708,7796,1550,0,0,859
JHM,1,2014,4806,2222,2584,562,0,0,361
JHM,1,2014,9949,4593,5356,1593,0,0,651
OLK,1,2014,4275,1794,2481,969,0,0,236
OLK,1,2014,15795,7025,8770,1803,0,0,1109
OLK,1,2014,6761,3434,3327,648,0,0,628
OLK,1,2014,10268,4693,5575,1220,0,0,723
OLK,1,2014,9305,4215,5090,893,0,0,599
ZLK,1,2014,7348,3316,4032,975,0,0,528
ZLK,1,2014,8054,3792,4262,1203,0,0,560
ZLK,1,2014,9874,4160,5714,1261,0,0,638
ZLK,1,2014,10210,4834,5376,1296,0,0,804
MSK,1,2014,10307,4685,5622,1051,0,0,607
MSK,1,2014,11933,5565,6368,1699,0,0,939
MSK,1,2014,23374,11176,12198,2075,0,0,1272
MSK,1,2014,9032,4084,4948,1274,0,0,608
MSK,1,2014,11979,5191,6788,1438,0,0,871
MSK,1,2014,27089,12500,14589,2482,0,0,1463
PHA,2,2014,46907,22966,23941,4924,1382,2276,1792
STC,2,2014,4025,1881,2144,373,94,94,257
STC,2,2014,4311,2129,2182,400,59,74,247
STC,2,2014,9709,4654,5055,591,89,100,561
STC,2,2014,6551,3186,3365,554,134,111,337
STC,2,2014,4860,2415,2445,319,81,78,207
STC,2,2014,6370,3181,3189,602,88,105,382
STC,2,2014,4227,2277,1950,457,135,210,207
STC,2,2014,5669,2761,2908,524,561,234,312
STC,2,2014,4143,2103,2040,593,160,77,244
STC,2,2014,4144,2103,2041,589,74,12,138
STC,2,2014,7907,3463,4444,631,94,164,432
STC,2,2014,3203,1581,1622,205,85,0,216
JHC,2,2014,8704,4074,4630,812,393,284,649
JHC,2,2014,4543,2103,2440,379,143,140,195
JHC,2,2014,5195,2420,2775,388,112,181,310
JHC,2,2014,3587,1718,1869,291,83,299,197
JHC,2,2014,2499,1017,1482,250,110,118,113
JHC,2,2014,4149,1899,2250,305,119,81,203
JHC,2,2014,6017,2848,3169,561,197,187,377
PLK,2,2014,2902,1420,1482,239,97,81,240
PLK,2,2014,4588,2077,2511,388,168,105,228
PLK,2,2014,8361,4279,4082,716,470,310,518
PLK,2,2014,2449,1150,1299,181,47,49,176
PLK,2,2014,3451,1701,1750,321,60,93,213
PLK,2,2014,1970,1097,873,218,69,69,156
PLK,2,2014,3269,1470,1799,245,55,122,152
KVK,2,2014,5140,2319,2821,440,201,5,216
KVK,2,2014,7753,3405,4348,588,291,63,443
KVK,2,2014,7108,3406,3702,423,118,127,508
ULK,2,2014,10670,5006,5664,386,267,145,731
ULK,2,2014,10808,5410,5398,693,133,127,590
ULK,2,2014,8427,4021,4406,587,153,174,592
ULK,2,2014,6916,3366,3550,429,113,108,448
ULK,2,2014,11030,5752,5278,738,153,3,799
ULK,2,2014,9437,4690,4747,705,197,105,484
ULK,2,2014,10689,4891,5798,723,180,142,528
LBK,2,2014,6986,3584,3402,467,250,147,448
LBK,2,2014,4940,2440,2500,414,144,124,363
LBK,2,2014,10580,5257,5323,1042,483,555,319
LBK,2,2014,4500,2111,2389,404,89,109,338
HKK,2,2014,8814,4028,4786,726,439,494,496
HKK,2,2014,3740,1718,2022,302,112,67,288
HKK,2,2014,5472,2430,3042,537,159,120,425
HKK,2,2014,3385,1722,1663,234,88,61,233
HKK,2,2014,7626,3420,4206,718,255,226,464
PAK,2,2014,6406,2795,3611,474,258,165,505
PAK,2,2014,7575,3737,3838,627,358,160,563
PAK,2,2014,7120,3215,3905,426,177,195,576
PAK,2,2014,7028,3198,3830,522,286,265,530
VYS,2,2014,4943,2355,2588,335,152,47,322
VYS,2,2014,6214,2795,3419,420,174,175,547
VYS,2,2014,2980,1379,1601,271,79,85,200
VYS,2,2014,8431,4043,4388,472,62,45,658
VYS,2,2014,7113,3283,3830,421,137,90,597
JHM,2,2014,5762,2789,2973,450,140,149,461
JHM,2,2014,23099,11481,11618,1443,804,892,1112
JHM,2,2014,10414,5134,5280,1138,191,82,788
JHM,2,2014,7563,3358,4205,364,228,211,533
JHM,2,2014,13380,5619,7761,792,198,187,814
JHM,2,2014,4715,2163,2552,338,70,97,342
JHM,2,2014,9890,4551,5339,617,139,92,622
OLK,2,2014,4176,1734,2442,204,88,36,247
OLK,2,2014,15808,7051,8757,1228,444,276,1102
OLK,2,2014,6895,3512,3383,718,261,157,759
OLK,2,2014,10351,4740,5611,745,254,93,711
OLK,2,2014,9084,4084,5000,396,198,181,577
ZLK,2,2014,7311,3261,4050,485,177,127,520
ZLK,2,2014,7903,3719,4184,609,205,154,555
ZLK,2,2014,9745,4114,5631,549,190,170,608
ZLK,2,2014,10134,4818,5316,830,289,175,771
MSK,2,2014,10115,4538,5577,560,56,49,604
MSK,2,2014,11946,5579,6367,1021,381,279,905
MSK,2,2014,23559,11268,12291,1607,168,150,1276
MSK,2,2014,8861,3979,4882,660,290,154,588
MSK,2,2014,11957,5134,6823,791,135,228,875
MSK,2,2014,27181,12549,14632,1745,843,787,1461
PHA,3,2014,46768,22808,23960,4680,1498,1798,1477
STC,3,2014,3849,1843,2006,358,137,72,233
STC,3,2014,4134,2070,2064,388,124,115,196
STC,3,2014,9672,4644,5028,803,113,72,518
STC,3,2014,6302,3114,3188,539,418,133,344
STC,3,2014,4563,2247,2316,347,79,148,150
STC,3,2014,6203,3142,3061,431,112,101,314
STC,3,2014,4079,2210,1869,420,258,220,218
STC,3,2014,5518,2673,2845,465,184,66,241
STC,3,2014,4135,2102,2033,584,108,85,193
STC,3,2014,4164,2151,2013,447,101,22,77
STC,3,2014,7517,3372,4145,572,135,80,385
STC,3,2014,3128,1560,1568,243,52,67,181
JHC,3,2014,8365,4009,4356,916,409,379,599
JHC,3,2014,4319,2056,2263,374,213,136,198
JHC,3,2014,4685,2286,2399,332,108,100,256
JHC,3,2014,3428,1682,1746,379,109,85,176
JHC,3,2014,2329,1001,1328,297,132,83,142
JHC,3,2014,3919,1814,2105,287,163,99,193
JHC,3,2014,5693,2734,2959,408,223,147,340
PLK,3,2014,2658,1341,1317,213,160,59,111
PLK,3,2014,4208,2009,2199,362,165,103,197
PLK,3,2014,8081,4194,3887,802,578,524,462
PLK,3,2014,2332,1120,1212,201,64,29,113
PLK,3,2014,3246,1613,1633,324,128,41,143
PLK,3,2014,1848,1016,832,206,75,60,99
PLK,3,2014,3172,1482,1690,286,80,24,119
KVK,3,2014,4883,2201,2682,517,153,61,157
KVK,3,2014,7440,3268,4172,570,208,324,342
KVK,3,2014,6953,3342,3611,567,77,73,343
ULK,3,2014,10518,4913,5605,786,174,165,534
ULK,3,2014,10522,5342,5180,745,157,150,444
ULK,3,2014,8251,3979,4272,583,161,108,372
ULK,3,2014,6907,3362,3545,793,108,24,362
ULK,3,2014,10833,5647,5186,750,199,201,419
ULK,3,2014,9304,4640,4664,760,215,168,448
ULK,3,2014,10616,4848,5768,685,119,188,456
LBK,3,2014,6948,3589,3359,704,257,207,371
LBK,3,2014,4894,2402,2492,456,177,129,269
LBK,3,2014,10521,5290,5231,1160,499,554,436
LBK,3,2014,4329,2077,2252,362,111,56,241
HKK,3,2014,8584,3966,4618,681,532,537,428
HKK,3,2014,3549,1679,1870,292,95,74,220
HKK,3,2014,5269,2394,2875,451,247,192,260
HKK,3,2014,3232,1627,1605,346,114,53,160
HKK,3,2014,7386,3366,4020,557,214,277,413
PAK,3,2014,5978,2669,3309,479,269,187,390
PAK,3,2014,7510,3707,3803,853,359,1102,440
PAK,3,2014,6854,3154,3700,502,213,128,459
PAK,3,2014,6864,3153,3711,662,304,355,410
VYS,3,2014,4650,2296,2354,355,149,69,287
VYS,3,2014,5903,2736,3167,519,217,195,382
VYS,3,2014,2820,1339,1481,251,111,57,160
VYS,3,2014,8058,3949,4109,553,189,23,570
VYS,3,2014,6821,3267,3554,543,132,102,490
JHM,3,2014,5638,2744,2894,454,129,75,397
JHM,3,2014,23238,11565,11673,1951,914,950,1166
JHM,3,2014,10330,5101,5229,1050,220,117,721
JHM,3,2014,7223,3279,3944,580,323,225,481
JHM,3,2014,12916,5562,7354,859,356,268,728
JHM,3,2014,4520,2121,2399,377,108,100,283
JHM,3,2014,9335,4473,4862,682,175,137,607
OLK,3,2014,3934,1660,2274,324,54,68,199
OLK,3,2014,15293,6932,8361,1151,518,561,901
OLK,3,2014,6549,3410,3139,461,237,238,358
OLK,3,2014,9951,4660,5291,631,239,241,599
OLK,3,2014,8918,4096,4822,748,250,172,467
ZLK,3,2014,7123,3196,3927,511,267,202,418
ZLK,3,2014,7552,3632,3920,564,146,97,423
ZLK,3,2014,9526,4061,5465,767,264,190,535
ZLK,3,2014,9720,4661,5059,789,362,219,587
MSK,3,2014,9816,4484,5332,567,88,84,488
MSK,3,2014,11694,5497,6197,969,413,456,732
MSK,3,2014,23241,11125,12116,1396,271,182,1022
MSK,3,2014,8657,3930,4727,688,362,358,433
MSK,3,2014,11540,5048,6492,820,497,141,749
MSK,3,2014,26889,12493,14396,1845,812,496,1202
PHA,4,2014,46318,22725,23593,4662,1394,1402,1408
STC,4,2014,3418,1710,1708,386,165,60,200
STC,4,2014,3952,2008,1944,363,245,38,189
STC,4,2014,9492,4586,4906,785,177,79,496
STC,4,2014,5862,2991,2871,505,426,200,318
STC,4,2014,4188,2131,2057,325,147,66,142
STC,4,2014,5961,3084,2877,530,156,54,289
STC,4,2014,3974,2193,1781,438,247,247,208
STC,4,2014,5234,2574,2660,433,153,269,231
STC,4,2014,4038,2065,1973,549,156,189,179
STC,4,2014,4132,2149,1983,402,84,64,60
STC,4,2014,7037,3238,3799,567,171,112,344
STC,4,2014,2910,1486,1424,222,44,54,182
JHC,4,2014,7959,3913,4046,905,438,383,553
JHC,4,2014,4007,1965,2042,356,188,138,185
JHC,4,2014,4086,2117,1969,406,172,83,250
JHC,4,2014,3089,1597,1492,350,252,53,168
JHC,4,2014,2026,960,1066,239,122,129,135
JHC,4,2014,3599,1771,1828,323,99,65,173
JHC,4,2014,5308,2647,2661,457,259,184,349
PLK,4,2014,2478,1304,1174,244,103,107,111
PLK,4,2014,3655,1840,1815,311,233,157,153
PLK,4,2014,7703,4043,3660,739,710,644,424
PLK,4,2014,2173,1083,1090,197,50,42,113
PLK,4,2014,2979,1529,1450,312,74,37,120
PLK,4,2014,1726,972,754,197,132,56,92
PLK,4,2014,2853,1376,1477,239,132,65,117
KVK,4,2014,4485,2044,2441,436,138,100,142
KVK,4,2014,7078,3113,3965,602,227,288,331
KVK,4,2014,6697,3226,3471,523,91,193,326
ULK,4,2014,9995,4716,5279,683,217,238,505
ULK,4,2014,10340,5274,5066,835,175,104,427
ULK,4,2014,7735,3780,3955,582,166,161,329
ULK,4,2014,6623,3281,3342,584,113,167,334
ULK,4,2014,10616,5528,5088,683,177,194,422
ULK,4,2014,9015,4533,4482,732,206,175,354
ULK,4,2014,10496,4834,5662,859,147,117,458
LBK,4,2014,6492,3404,3088,570,188,292,328
LBK,4,2014,4719,2342,2377,455,181,132,242
LBK,4,2014,10258,5248,5010,1017,460,528,409
LBK,4,2014,4134,2057,2077,427,138,58,226
HKK,4,2014,8074,3863,4211,653,503,501,358
HKK,4,2014,3186,1592,1594,338,147,135,196
HKK,4,2014,4788,2276,2512,497,212,269,198
HKK,4,2014,2886,1524,1362,304,58,79,139
HKK,4,2014,7065,3356,3709,716,259,171,403
PAK,4,2014,5273,2494,2779,449,286,381,332
PAK,4,2014,6877,3470,3407,665,561,338,407
PAK,4,2014,6043,2981,3062,461,343,100,425
PAK,4,2014,6245,2988,3257,508,438,247,351
VYS,4,2014,4236,2215,2021,355,103,71,263
VYS,4,2014,5429,2655,2774,497,246,121,369
VYS,4,2014,2481,1279,1202,242,128,84,139
VYS,4,2014,7122,3665,3457,439,138,99,502
VYS,4,2014,6149,3133,3016,454,179,96,438
JHM,4,2014,5327,2633,2694,415,138,151,404
JHM,4,2014,23063,11616,11447,1842,851,785,1159
JHM,4,2014,9813,4975,4838,779,219,77,718
JHM,4,2014,6409,3053,3356,557,260,181,446
JHM,4,2014,11872,5288,6584,721,310,284,681
JHM,4,2014,4190,2010,2180,346,130,62,272
JHM,4,2014,8211,4074,4137,497,156,112,542
OLK,4,2014,3399,1535,1864,278,74,79,169
OLK,4,2014,14322,6697,7625,1086,545,504,831
OLK,4,2014,6076,3232,2844,510,240,219,331
OLK,4,2014,9426,4569,4857,678,266,179,553
OLK,4,2014,8179,3899,4280,582,365,232,429
ZLK,4,2014,6649,3113,3536,552,202,239,377
ZLK,4,2014,6966,3509,3457,602,155,82,431
ZLK,4,2014,8847,3927,4920,734,249,168,494
ZLK,4,2014,9096,4488,4608,769,321,223,549
MSK,4,2014,9149,4320,4829,600,129,74,441
MSK,4,2014,11078,5319,5759,902,443,292,682
MSK,4,2014,22878,11015,11863,1435,291,281,989
MSK,4,2014,8123,3755,4368,809,405,298,408
MSK,4,2014,10735,4867,5868,794,213,219,686
MSK,4,2014,26406,12406,14000,1884,659,780,1197
PHA,5,2014,45874,22663,23211,4265,1358,1365,1312
STC,5,2014,3114,1595,1519,320,198,99,158
STC,5,2014,3857,1983,1874,308,87,92,179
STC,5,2014,9313,4532,4781,556,133,126,452
STC,5,2014,5589,2974,2615,505,743,315,290
STC,5,2014,3939,2088,1851,381,175,106,128
STC,5,2014,5823,3055,2768,425,201,156,262
STC,5,2014,3808,2119,1689,353,268,181,173
STC,5,2014,5009,2532,2477,363,161,384,209
STC,5,2014,3868,2022,1846,481,220,100,165
STC,5,2014,4080,2146,1934,339,80,4,57
STC,5,2014,6723,3193,3530,492,127,85,320
STC,5,2014,2819,1450,1369,234,40,54,153
JHC,5,2014,7565,3815,3750,794,432,463,509
JHC,5,2014,3722,1867,1855,265,156,100,162
JHC,5,2014,3656,1964,1692,297,118,164,224
JHC,5,2014,2777,1491,1286,267,213,84,155
JHC,5,2014,1810,917,893,217,351,137,106
JHC,5,2014,3334,1702,1632,233,114,94,135
JHC,5,2014,5071,2636,2435,451,240,272,324
PLK,5,2014,2342,1273,1069,217,237,82,99
PLK,5,2014,3357,1739,1618,347,173,141,133
PLK,5,2014,7498,4014,3484,785,601,570,386
PLK,5,2014,2097,1092,1005,234,76,67,111
PLK,5,2014,2799,1478,1321,258,73,79,115
PLK,5,2014,1600,909,691,168,53,48,72
PLK,5,2014,2707,1318,1389,246,296,151,113
KVK,5,2014,4196,1973,2223,397,147,79,140
KVK,5,2014,6741,3032,3709,474,267,104,288
KVK,5,2014,6468,3148,3320,423,93,71,273
ULK,5,2014,9483,4574,4909,661,185,149,441
ULK,5,2014,10089,5196,4893,644,196,100,382
ULK,5,2014,7481,3724,3757,598,169,194,292
ULK,5,2014,6422,3182,3240,478,187,47,315
ULK,5,2014,10474,5486,4988,622,179,77,412
ULK,5,2014,8769,4453,4316,645,233,139,321
ULK,5,2014,10242,4753,5489,542,206,109,438
LBK,5,2014,6226,3294,2932,517,375,167,312
LBK,5,2014,4530,2320,2210,372,134,119,221
LBK,5,2014,10012,5233,4779,827,572,484,401
LBK,5,2014,3839,1993,1846,274,89,83,204
HKK,5,2014,7711,3760,3951,569,473,540,344
HKK,5,2014,2889,1531,1358,277,131,104,172
HKK,5,2014,4467,2219,2248,392,208,141,189
HKK,5,2014,2684,1480,1204,264,82,77,116
HKK,5,2014,6684,3284,3400,546,213,173,361
PAK,5,2014,4757,2408,2349,375,213,204,272
PAK,5,2014,6397,3317,3080,575,491,354,353
PAK,5,2014,5572,2840,2732,348,258,214,374
PAK,5,2014,5819,2906,2913,453,365,267,293
VYS,5,2014,4007,2181,1826,281,148,118,242
VYS,5,2014,5140,2600,2540,460,225,176,331
VYS,5,2014,2237,1223,1014,215,105,60,116
VYS,5,2014,6571,3497,3074,406,144,66,460
VYS,5,2014,5742,3024,2718,408,177,130,407
JHM,5,2014,4998,2545,2453,340,101,154,351
JHM,5,2014,22860,11576,11284,1435,829,840,1098
JHM,5,2014,9463,4876,4587,736,255,125,666
JHM,5,2014,5948,2927,3021,475,297,218,381
JHM,5,2014,11150,5156,5994,647,337,325,603
JHM,5,2014,3906,1924,1982,343,144,110,244
JHM,5,2014,7555,3846,3709,468,152,89,465
OLK,5,2014,3058,1438,1620,203,87,53,138
OLK,5,2014,13762,6664,7098,959,581,506,755
OLK,5,2014,5657,3062,2595,377,177,157,281
OLK,5,2014,8950,4462,4488,461,255,207,490
OLK,5,2014,7704,3769,3935,515,359,335,370
ZLK,5,2014,6246,2982,3264,423,253,287,330
ZLK,5,2014,6532,3354,3178,509,213,159,383
ZLK,5,2014,8282,3843,4439,595,208,212,449
ZLK,5,2014,8514,4353,4161,677,282,180,497
MSK,5,2014,8661,4211,4450,517,71,70,405
MSK,5,2014,10563,5187,5376,788,309,355,662
MSK,5,2014,22522,10908,11614,1202,273,193,949
MSK,5,2014,7712,3646,4066,738,362,296,348
MSK,5,2014,10119,4759,5360,670,227,208,617
MSK,5,2014,26011,12347,13664,1510,548,588,1116
PHA,6,2014,45507,22781,22726,4382,1962,2234,1184
STC,6,2014,2955,1554,1401,373,127,145,138
STC,6,2014,3820,2000,1820,363,302,193,165
STC,6,2014,9275,4552,4723,726,142,106,402
STC,6,2014,5423,2937,2486,489,254,111,250
STC,6,2014,3785,2057,1728,320,241,193,117
STC,6,2014,5742,3068,2674,453,200,138,226
STC,6,2014,3661,2070,1591,358,453,230,159
STC,6,2014,4866,2525,2341,402,249,398,187
STC,6,2014,3818,2033,1785,497,131,72,154
STC,6,2014,4032,2138,1894,371,66,59,65
STC,6,2014,6546,3145,3401,523,104,118,277
STC,6,2014,2776,1426,1350,251,51,32,138
JHC,6,2014,7252,3720,3532,758,386,405,429
JHC,6,2014,3548,1794,1754,269,146,184,137
JHC,6,2014,3358,1845,1513,325,110,98,180
JHC,6,2014,2681,1497,1184,292,151,216,147
JHC,6,2014,1704,894,810,215,100,223,83
JHC,6,2014,3200,1655,1545,240,154,92,115
JHC,6,2014,4939,2621,2318,404,206,181,266
PLK,6,2014,2273,1271,1002,217,175,116,99
PLK,6,2014,3257,1746,1511,342,157,167,125
PLK,6,2014,7355,3985,3370,807,634,498,345
PLK,6,2014,2048,1088,960,191,155,46,91
PLK,6,2014,2726,1466,1260,286,88,72,100
PLK,6,2014,1561,883,678,201,120,68,75
PLK,6,2014,2594,1270,1324,215,126,46,101
KVK,6,2014,4039,1923,2116,418,158,187,122
KVK,6,2014,6605,3009,3596,495,288,408,228
KVK,6,2014,6341,3125,3216,444,106,104,233
ULK,6,2014,9210,4515,4695,605,195,147,369
ULK,6,2014,9918,5131,4787,658,173,216,339
ULK,6,2014,7334,3731,3603,562,147,104,251
ULK,6,2014,6281,3124,3157,508,179,127,276
ULK,6,2014,10330,5472,4858,699,232,94,366
ULK,6,2014,8592,4385,4207,685,217,252,272
ULK,6,2014,10180,4758,5422,599,121,189,390
LBK,6,2014,6008,3254,2754,555,250,155,250
LBK,6,2014,4422,2312,2110,384,139,108,198
LBK,6,2014,9811,5214,4597,808,519,601,396
LBK,6,2014,3754,1981,1773,354,88,103,189
HKK,6,2014,7561,3740,3821,588,470,526,329
HKK,6,2014,2749,1482,1267,293,132,81,138
HKK,6,2014,4268,2178,2090,412,154,201,158
HKK,6,2014,2572,1445,1127,284,114,81,104
HKK,6,2014,6390,3255,3135,446,340,143,295
PAK,6,2014,4588,2407,2181,434,241,178,256
PAK,6,2014,6113,3259,2854,632,562,423,296
PAK,6,2014,5364,2789,2575,382,218,169,282
PAK,6,2014,5536,2822,2714,520,574,418,255
VYS,6,2014,3873,2137,1736,307,260,133,189
VYS,6,2014,5019,2594,2425,463,264,359,259
VYS,6,2014,2115,1177,938,250,137,109,114
VYS,6,2014,6371,3471,2900,442,130,162,344
VYS,6,2014,5542,2973,2569,441,246,175,329
JHM,6,2014,4932,2565,2367,453,147,139,286
JHM,6,2014,22744,11645,11099,1709,1023,779,1001
JHM,6,2014,9268,4871,4397,801,207,307,562
JHM,6,2014,5705,2846,2859,469,413,344,336
JHM,6,2014,10769,5092,5677,720,208,249,470
JHM,6,2014,3763,1906,1857,369,75,107,203
JHM,6,2014,7178,3746,3432,483,182,176,379
OLK,6,2014,2871,1383,1488,202,65,86,106
OLK,6,2014,13496,6646,6850,1060,751,657,632
OLK,6,2014,5474,3029,2445,460,198,165,233
OLK,6,2014,8799,4423,4376,586,229,181,425
OLK,6,2014,7439,3726,3713,556,311,305,283
ZLK,6,2014,6107,3003,3104,499,164,142,256
ZLK,6,2014,6324,3314,3010,571,193,193,331
ZLK,6,2014,8025,3813,4212,631,282,259,353
ZLK,6,2014,8443,4448,3995,836,258,264,400
MSK,6,2014,8435,4170,4265,474,110,75,337
MSK,6,2014,10329,5170,5159,877,494,331,582
MSK,6,2014,22273,10850,11423,1376,370,255,779
MSK,6,2014,7580,3700,3880,772,286,354,302
MSK,6,2014,9844,4759,5085,725,186,415,507
MSK,6,2014,25793,12386,13407,1737,723,886,1012
PHA,7,2014,46397,23751,22646,5298,1151,1212,1227
STC,7,2014,2894,1569,1325,407,140,109,138
STC,7,2014,3848,2082,1766,435,138,193,155
STC,7,2014,9406,4729,4677,820,269,180,411
STC,7,2014,5502,3034,2468,608,251,907,256
STC,7,2014,3834,2141,1693,429,137,228,118
STC,7,2014,5808,3173,2635,593,140,206,236
STC,7,2014,3758,2158,1600,480,328,359,172
STC,7,2014,4985,2639,2346,550,443,201,195
STC,7,2014,3906,2156,1750,618,211,209,153
STC,7,2014,4141,2261,1880,510,73,173,84
STC,7,2014,6646,3267,3379,685,96,109,300
STC,7,2014,2808,1493,1315,293,55,11,158
JHC,7,2014,7300,3856,3444,1032,470,274,499
JHC,7,2014,3417,1749,1668,303,109,155,130
JHC,7,2014,3242,1838,1404,391,98,109,169
JHC,7,2014,2561,1484,1077,326,131,201,135
JHC,7,2014,1656,900,756,236,472,127,91
JHC,7,2014,3221,1698,1523,356,120,85,114
JHC,7,2014,5041,2764,2277,590,198,201,290
PLK,7,2014,2287,1311,976,278,100,125,102
PLK,7,2014,3319,1847,1472,461,144,152,134
PLK,7,2014,7669,4262,3407,1160,722,642,411
PLK,7,2014,2055,1127,928,241,75,100,89
PLK,7,2014,2851,1579,1272,451,112,76,133
PLK,7,2014,1542,885,657,221,53,49,86
PLK,7,2014,2610,1308,1302,316,154,104,105
KVK,7,2014,4082,2010,2072,533,181,77,141
KVK,7,2014,6741,3174,3567,705,265,120,228
KVK,7,2014,6443,3236,3207,601,84,127,237
ULK,7,2014,9184,4594,4590,832,207,187,365
ULK,7,2014,9926,5228,4698,882,220,198,349
ULK,7,2014,7367,3827,3540,762,178,175,260
ULK,7,2014,6264,3169,3095,519,148,298,280
ULK,7,2014,10193,5492,4701,704,171,155,333
ULK,7,2014,8507,4395,4112,726,227,135,259
ULK,7,2014,10240,4866,5374,678,130,163,383
LBK,7,2014,5912,3266,2646,590,529,288,238
LBK,7,2014,4479,2405,2074,519,140,127,223
LBK,7,2014,9949,5417,4532,1062,510,372,407
LBK,7,2014,3760,1993,1767,367,100,92,193
HKK,7,2014,7685,3848,3837,845,513,399,392
HKK,7,2014,2821,1567,1254,395,356,155,143
HKK,7,2014,4396,2289,2107,608,156,197,179
HKK,7,2014,2575,1495,1080,357,115,43,136
HKK,7,2014,6404,3317,3087,634,254,251,277
PAK,7,2014,4679,2581,2098,657,156,174,271
PAK,7,2014,6173,3389,2784,832,796,610,311
PAK,7,2014,5428,2935,2493,598,182,181,293
PAK,7,2014,5679,3006,2673,767,466,298,277
VYS,7,2014,3977,2258,1719,510,157,59,217
VYS,7,2014,5184,2767,2417,661,281,335,292
VYS,7,2014,2122,1222,900,288,167,95,116
VYS,7,2014,6447,3585,2862,623,76,42,352
VYS,7,2014,5572,3063,2509,574,111,138,350
JHM,7,2014,4941,2629,2312,502,166,146,308
JHM,7,2014,23229,12092,11137,2231,1242,1099,1028
JHM,7,2014,9421,5098,4323,1092,206,700,519
JHM,7,2014,5644,2894,2750,634,240,320,334
JHM,7,2014,10830,5265,5565,1065,253,258,521
JHM,7,2014,3801,1990,1811,463,89,69,211
JHM,7,2014,7174,3850,3324,673,198,54,354
OLK,7,2014,2757,1349,1408,263,70,50,110
OLK,7,2014,13617,6878,6739,1360,707,718,682
OLK,7,2014,5455,3074,2381,578,246,262,247
OLK,7,2014,8897,4519,4378,699,315,230,451
OLK,7,2014,7440,3799,3641,705,305,229,322
ZLK,7,2014,6137,3103,3034,630,193,172,274
ZLK,7,2014,6301,3422,2879,747,187,181,353
ZLK,7,2014,7978,3898,4080,802,286,283,392
ZLK,7,2014,8508,4611,3897,992,314,478,421
MSK,7,2014,8418,4263,4155,615,151,128,353
MSK,7,2014,10413,5340,5073,1130,352,349,611
MSK,7,2014,22195,10981,11214,1592,257,288,788
MSK,7,2014,7652,3817,3835,899,334,240,331
MSK,7,2014,9793,4873,4920,921,181,203,526
MSK,7,2014,25870,12678,13192,1968,916,393,1019
PHA,8,2014,46031,23739,22292,3923,1754,1021,1258
STC,8,2014,2808,1529,1279,307,121,111,151
STC,8,2014,3802,2073,1729,335,114,239,166
STC,8,2014,9281,4665,4616,636,171,124,422
STC,8,2014,5382,3007,2375,427,447,267,258
STC,8,2014,3790,2137,1653,312,205,160,132
STC,8,2014,5774,3149,2625,420,141,110,249
STC,8,2014,3783,2186,1597,356,246,165,177
STC,8,2014,5006,2668,2338,440,232,300,198
STC,8,2014,3926,2164,1762,530,323,44,173
STC,8,2014,4164,2294,1870,348,101,39,107
STC,8,2014,6646,3303,3343,506,93,116,334
STC,8,2014,2775,1473,1302,223,32,48,165
JHC,8,2014,7003,3750,3253,739,304,315,499
JHC,8,2014,3357,1742,1615,235,194,68,132
JHC,8,2014,3126,1798,1328,312,155,89,187
JHC,8,2014,2504,1454,1050,251,135,73,135
JHC,8,2014,1598,858,740,221,72,276,101
JHC,8,2014,3221,1711,1510,316,190,197,139
JHC,8,2014,4963,2736,2227,370,448,272,293
PLK,8,2014,2299,1320,979,220,162,102,111
PLK,8,2014,3290,1830,1460,328,162,141,143
PLK,8,2014,7665,4279,3386,789,815,569,454
PLK,8,2014,2047,1139,908,199,79,15,103
PLK,8,2014,2844,1580,1264,294,44,32,165
PLK,8,2014,1530,889,641,183,72,53,86
PLK,8,2014,2547,1293,1254,208,96,22,103
KVK,8,2014,4026,1958,2068,396,176,311,135
KVK,8,2014,6683,3157,3526,485,311,228,245
KVK,8,2014,6377,3233,3144,435,147,130,264
ULK,8,2014,9048,4568,4480,590,153,143,370
ULK,8,2014,9813,5188,4625,681,167,170,351
ULK,8,2014,7262,3844,3418,529,195,138,295
ULK,8,2014,6129,3105,3024,451,145,41,281
ULK,8,2014,9976,5393,4583,560,218,331,355
ULK,8,2014,8356,4367,3989,590,190,167,273
ULK,8,2014,10195,4836,5359,563,153,116,392
LBK,8,2014,5796,3226,2570,410,216,210,259
LBK,8,2014,4441,2393,2048,371,111,106,233
LBK,8,2014,9837,5410,4427,755,419,283,405
LBK,8,2014,3739,1998,1741,296,114,60,210
HKK,8,2014,7615,3815,3800,586,443,469,418
HKK,8,2014,2747,1513,1234,262,96,35,153
HKK,8,2014,4328,2253,2075,435,157,91,210
HKK,8,2014,2538,1478,1060,284,62,105,152
HKK,8,2014,6242,3262,2980,429,193,233,286
PAK,8,2014,4575,2542,2033,399,209,140,297
PAK,8,2014,6052,3333,2719,582,702,683,333
PAK,8,2014,5362,2922,2440,399,200,185,297
PAK,8,2014,5531,2950,2581,502,291,203,307
VYS,8,2014,3956,2231,1725,337,174,76,238
VYS,8,2014,5089,2753,2336,442,206,183,332
VYS,8,2014,2120,1206,914,243,110,101,135
VYS,8,2014,6477,3630,2847,493,73,44,421
VYS,8,2014,5603,3098,2505,425,149,223,396
JHM,8,2014,4873,2617,2256,378,145,124,355
JHM,8,2014,23102,12113,10989,1472,983,719,1052
JHM,8,2014,9377,5081,4296,796,299,55,601
JHM,8,2014,5481,2820,2661,474,264,220,353
JHM,8,2014,10579,5176,5403,694,267,260,538
JHM,8,2014,3752,1969,1783,369,65,68,247
JHM,8,2014,7264,3954,3310,626,379,307,401
OLK,8,2014,2625,1298,1327,170,52,72,108
OLK,8,2014,13429,6846,6583,964,610,586,690
OLK,8,2014,5333,3026,2307,420,192,174,256
OLK,8,2014,8859,4528,4331,575,229,171,509
OLK,8,2014,7283,3705,3578,510,293,238,326
ZLK,8,2014,6129,3110,3019,501,156,147,315
ZLK,8,2014,6197,3361,2836,550,186,203,385
ZLK,8,2014,7885,3891,3994,600,209,206,433
ZLK,8,2014,8396,4573,3823,710,353,336,485
MSK,8,2014,8324,4238,4086,455,87,86,368
MSK,8,2014,10324,5341,4983,889,458,593,618
MSK,8,2014,22178,11061,11117,1394,285,277,877
MSK,8,2014,7594,3844,3750,665,257,213,351
MSK,8,2014,9575,4798,4777,633,209,119,575
MSK,8,2014,25591,12592,12999,1484,770,444,1058
PHA,9,2014,44962,23028,21934,5523,1747,1363,1470
STC,9,2014,2774,1512,1262,551,210,111,236
STC,9,2014,3751,2012,1739,496,279,157,219
STC,9,2014,9244,4598,4646,945,235,193,571
STC,9,2014,5296,2954,2342,689,251,264,327
STC,9,2014,3691,2060,1631,495,189,158,141
STC,9,2014,5816,3150,2666,730,189,198,398
STC,9,2014,3799,2170,1629,634,353,469,270
STC,9,2014,5003,2611,2392,657,181,135,227
STC,9,2014,3919,2172,1747,718,138,235,277
STC,9,2014,4056,2218,1838,552,84,15,211
STC,9,2014,6555,3217,3338,729,179,130,401
STC,9,2014,2725,1453,1272,344,29,24,182
JHC,9,2014,6767,3590,3177,1146,459,335,574
JHC,9,2014,3297,1707,1590,365,133,161,150
JHC,9,2014,3116,1808,1308,523,101,158,261
JHC,9,2014,2426,1386,1040,443,136,274,174
JHC,9,2014,1536,777,759,282,115,82,124
JHC,9,2014,3223,1683,1540,489,110,104,208
JHC,9,2014,4859,2645,2214,639,209,343,362
PLK,9,2014,2231,1260,971,308,192,208,152
PLK,9,2014,3224,1771,1453,567,192,156,213
PLK,9,2014,7435,4052,3383,1114,572,566,503
PLK,9,2014,2030,1124,906,340,50,52,165
PLK,9,2014,2824,1544,1280,469,85,134,219
PLK,9,2014,1521,867,654,283,120,99,108
PLK,9,2014,2485,1251,1234,351,151,150,148
KVK,9,2014,4009,1951,2058,610,202,116,190
KVK,9,2014,6711,3148,3563,857,358,270,388
KVK,9,2014,6427,3204,3223,760,78,80,377
ULK,9,2014,9002,4530,4472,1026,183,314,506
ULK,9,2014,9876,5191,4685,1204,248,233,493
ULK,9,2014,7295,3836,3459,928,251,135,409
ULK,9,2014,6071,3048,3023,751,223,165,353
ULK,9,2014,9978,5397,4581,990,222,254,462
ULK,9,2014,8306,4280,4026,948,228,287,374
ULK,9,2014,10181,4790,5391,897,154,170,478
LBK,9,2014,5735,3174,2561,738,258,249,368
LBK,9,2014,4426,2363,2063,650,131,130,284
LBK,9,2014,9737,5344,4393,1222,476,370,514
LBK,9,2014,3678,1939,1739,479,144,91,282
HKK,9,2014,7547,3739,3808,1027,550,426,548
HKK,9,2014,2712,1486,1226,476,169,283,235
HKK,9,2014,4309,2228,2081,731,172,199,307
HKK,9,2014,2489,1400,1089,471,150,101,207
HKK,9,2014,6168,3207,2961,825,301,417,460
PAK,9,2014,4475,2443,2032,718,164,220,411
PAK,9,2014,5814,3158,2656,955,565,462,451
PAK,9,2014,5262,2801,2461,735,268,305,411
PAK,9,2014,5421,2878,2543,834,341,260,407
VYS,9,2014,3826,2134,1692,533,205,198,305
VYS,9,2014,4939,2608,2331,708,493,375,404
VYS,9,2014,2048,1153,895,333,115,157,171
VYS,9,2014,6482,3599,2883,792,123,133,550
VYS,9,2014,5586,3043,2543,766,212,168,492
JHM,9,2014,4833,2571,2262,677,180,127,417
JHM,9,2014,22786,11879,10907,2263,1419,1237,1199
JHM,9,2014,9114,4930,4184,1223,220,160,744
JHM,9,2014,5522,2831,2691,943,364,286,503
JHM,9,2014,10461,5119,5342,1190,303,227,686
JHM,9,2014,3760,1973,1787,633,71,142,365
JHM,9,2014,7099,3816,3283,925,227,319,548
OLK,9,2014,2602,1314,1288,355,116,94,155
OLK,9,2014,13240,6676,6564,1562,882,778,870
OLK,9,2014,5294,2990,2304,762,252,226,385
OLK,9,2014,8810,4525,4285,934,237,252,640
OLK,9,2014,7187,3639,3548,915,313,381,435
ZLK,9,2014,6075,3067,3008,736,172,140,437
ZLK,9,2014,6018,3244,2774,861,290,239,532
ZLK,9,2014,7678,3748,3930,934,258,370,577
ZLK,9,2014,8243,4437,3806,1137,412,225,636
MSK,9,2014,8354,4280,4074,840,155,121,474
MSK,9,2014,10174,5213,4961,1429,546,474,777
MSK,9,2014,22077,10978,11099,2021,407,378,1069
MSK,9,2014,7539,3804,3735,1096,316,331,465
MSK,9,2014,9735,4881,4854,1312,297,215,782
MSK,9,2014,25422,12469,12953,2386,934,648,1215
PHA,10,2014,44307,22697,21610,5031,2204,1398,1528
STC,10,2014,2668,1469,1199,406,181,163,217
STC,10,2014,3551,1915,1636,337,133,136,203
STC,10,2014,9076,4476,4600,745,286,202,516
STC,10,2014,5197,2893,2304,579,284,183,326
STC,10,2014,3576,1993,1583,398,136,141,144
STC,10,2014,5724,3082,2642,507,242,217,410
STC,10,2014,3780,2140,1640,501,246,314,236
STC,10,2014,4898,2566,2332,452,141,177,246
STC,10,2014,3823,2101,1722,529,229,279,252
STC,10,2014,3968,2142,1826,454,109,13,194
STC,10,2014,6472,3150,3322,636,145,90,388
STC,10,2014,2652,1417,1235,247,100,22,180
JHC,10,2014,6715,3552,3163,975,366,370,564
JHC,10,2014,3263,1687,1576,371,122,171,156
JHC,10,2014,3139,1831,1308,478,101,129,274
JHC,10,2014,2343,1339,1004,350,151,112,168
JHC,10,2014,1561,804,757,284,139,78,130
JHC,10,2014,3131,1649,1482,313,100,191,195
JHC,10,2014,4780,2590,2190,499,316,316,332
PLK,10,2014,2133,1222,911,228,261,189,137
PLK,10,2014,3159,1714,1445,438,128,179,220
PLK,10,2014,7204,3942,3262,862,802,679,488
PLK,10,2014,2018,1120,898,283,102,72,175
PLK,10,2014,2729,1485,1244,351,69,82,216
PLK,10,2014,1465,845,620,191,106,21,102
PLK,10,2014,2405,1216,1189,271,322,284,145
KVK,10,2014,3968,1940,2028,480,213,168,183
KVK,10,2014,6592,3100,3492,615,379,242,366
KVK,10,2014,6321,3138,3183,551,80,75,363
ULK,10,2014,8943,4508,4435,761,139,132,505
ULK,10,2014,9810,5125,4685,812,190,222,484
ULK,10,2014,7181,3791,3390,687,224,260,375
ULK,10,2014,5985,3013,2972,571,208,296,337
ULK,10,2014,9891,5311,4580,735,182,170,451
ULK,10,2014,8067,4146,3921,708,245,235,353
ULK,10,2014,10141,4744,5397,712,213,189,474
LBK,10,2014,5538,3065,2473,648,186,375,349
LBK,10,2014,4346,2312,2034,436,165,151,280
LBK,10,2014,9439,5176,4263,860,427,345,492
LBK,10,2014,3666,1908,1758,400,148,95,274
HKK,10,2014,7297,3606,3691,665,521,501,533
HKK,10,2014,2567,1422,1145,327,147,181,206
HKK,10,2014,4181,2133,2048,476,200,184,273
HKK,10,2014,2361,1337,1024,308,164,142,184
HKK,10,2014,6080,3153,2927,640,382,317,419
PAK,10,2014,4325,2333,1992,504,228,136,366
PAK,10,2014,5665,3093,2572,825,435,314,416
PAK,10,2014,5119,2718,2401,447,221,266,402
PAK,10,2014,5240,2765,2475,576,295,468,374
VYS,10,2014,3766,2113,1653,384,121,165,279
VYS,10,2014,4913,2553,2360,597,282,354,415
VYS,10,2014,1997,1119,878,272,105,169,138
VYS,10,2014,6511,3615,2896,587,107,92,529
VYS,10,2014,5443,2954,2489,452,211,185,456
JHM,10,2014,4700,2514,2186,431,175,151,388
JHM,10,2014,22575,11720,10855,1845,1311,1279,1171
JHM,10,2014,8901,4777,4124,845,338,399,693
JHM,10,2014,5414,2790,2624,600,246,308,464
JHM,10,2014,10217,4999,5218,753,249,362,637
JHM,10,2014,3638,1933,1705,369,96,100,337
JHM,10,2014,7102,3837,3265,720,194,144,533
OLK,10,2014,2592,1296,1296,308,49,73,161
OLK,10,2014,13066,6578,6488,1183,611,544,880
OLK,10,2014,5226,2933,2293,513,145,207,372
OLK,10,2014,8636,4467,4169,626,264,227,618
OLK,10,2014,7011,3518,3493,610,523,436,421
ZLK,10,2014,5950,2999,2951,513,138,148,429
ZLK,10,2014,5844,3185,2659,615,281,223,493
ZLK,10,2014,7602,3700,3902,726,253,205,546
ZLK,10,2014,8103,4335,3768,818,335,400,570
MSK,10,2014,8305,4257,4048,574,134,103,455
MSK,10,2014,9899,4995,4904,1037,414,389,744
MSK,10,2014,21769,10825,10944,1506,274,340,1039
MSK,10,2014,7261,3674,3587,764,387,246,420
MSK,10,2014,9508,4758,4750,758,216,256,701
MSK,10,2014,25229,12368,12861,1877,916,650,1187
PHA,11,2014,43597,22322,21275,4243,1741,1061,1465
STC,11,2014,2581,1415,1166,424,77,105,174
STC,11,2014,3474,1850,1624,362,160,142,194
STC,11,2014,8878,4372,4506,642,202,357,461
STC,11,2014,5160,2855,2305,519,209,403,288
STC,11,2014,3567,1954,1613,404,95,215,133
STC,11,2014,5687,3061,2626,538,145,265,345
STC,11,2014,3684,2058,1626,390,329,254,211
STC,11,2014,4839,2511,2328,430,542,122,235
STC,11,2014,3816,2093,1723,439,121,20,246
STC,11,2014,3968,2117,1851,351,62,18,186
STC,11,2014,6570,3170,3400,658,140,96,366
STC,11,2014,2616,1399,1217,235,69,10,161
JHC,11,2014,6713,3522,3191,921,459,526,531
JHC,11,2014,3341,1749,1592,430,139,29,151
JHC,11,2014,3265,1869,1396,538,90,73,239
JHC,11,2014,2420,1329,1091,417,147,98,154
JHC,11,2014,1611,810,801,324,132,117,104
JHC,11,2014,3102,1603,1499,348,138,90,169
JHC,11,2014,4744,2547,2197,492,204,160,302
PLK,11,2014,2102,1180,922,243,175,76,110
PLK,11,2014,3346,1795,1551,576,195,133,179
PLK,11,2014,7124,3862,3262,815,542,734,459
PLK,11,2014,2026,1108,918,262,51,50,147
PLK,11,2014,2711,1461,1250,322,61,78,185
PLK,11,2014,1452,808,644,183,67,149,77
PLK,11,2014,2390,1192,1198,240,70,49,122
KVK,11,2014,3993,1942,2051,489,168,326,160
KVK,11,2014,6570,3097,3473,623,211,248,331
KVK,11,2014,6287,3101,3186,518,119,65,329
ULK,11,2014,8999,4471,4528,813,155,161,479
ULK,11,2014,9689,5053,4636,719,161,152,411
ULK,11,2014,7114,3725,3389,656,242,249,330
ULK,11,2014,5921,2946,2975,505,102,39,289
ULK,11,2014,9849,5298,4551,660,198,115,429
ULK,11,2014,8038,4125,3913,714,209,175,314
ULK,11,2014,10064,4694,5370,672,153,127,434
LBK,11,2014,5556,3073,2483,609,155,129,336
LBK,11,2014,4304,2288,2016,387,96,152,260
LBK,11,2014,9296,5076,4220,811,500,439,445
LBK,11,2014,3675,1881,1794,400,136,110,234
HKK,11,2014,7238,3586,3652,652,387,485,497
HKK,11,2014,2630,1419,1211,394,208,158,177
HKK,11,2014,4128,2096,2032,487,173,144,238
HKK,11,2014,2334,1329,1005,344,117,150,171
HKK,11,2014,6082,3128,2954,648,564,272,364
PAK,11,2014,4393,2293,2100,636,144,271,337
PAK,11,2014,5583,3003,2580,729,416,573,378
PAK,11,2014,5250,2719,2531,625,215,198,369
PAK,11,2014,5182,2705,2477,570,271,156,332
VYS,11,2014,3781,2090,1691,422,162,321,251
VYS,11,2014,4883,2506,2377,533,205,239,394
VYS,11,2014,2038,1118,920,292,119,33,119
VYS,11,2014,6651,3665,2986,681,87,62,475
VYS,11,2014,5461,2884,2577,517,126,177,421
JHM,11,2014,4677,2502,2175,446,133,125,354
JHM,11,2014,22324,11548,10776,1484,1134,946,1085
JHM,11,2014,8739,4585,4154,800,213,232,629
JHM,11,2014,5527,2829,2698,694,203,335,426
JHM,11,2014,10306,4961,5345,933,309,226,604
JHM,11,2014,3592,1883,1709,393,93,44,278
JHM,11,2014,7427,4009,3418,915,182,239,496
OLK,11,2014,2757,1357,1400,429,64,71,126
OLK,11,2014,12973,6481,6492,1092,531,627,817
OLK,11,2014,5218,2909,2309,515,178,127,325
OLK,11,2014,8568,4382,4186,586,205,180,573
OLK,11,2014,7013,3485,3528,671,332,376,389
ZLK,11,2014,5991,2976,3015,590,187,151,397
ZLK,11,2014,5842,3157,2685,656,252,190,432
ZLK,11,2014,7566,3609,3957,714,202,214,479
ZLK,11,2014,8044,4238,3806,811,312,372,526
MSK,11,2014,8357,4256,4101,631,62,94,412
MSK,11,2014,9821,4866,4955,967,458,513,652
MSK,11,2014,21557,10681,10876,1239,262,249,940
MSK,11,2014,7081,3510,3571,680,348,362,352
MSK,11,2014,9480,4655,4825,810,167,173,637
MSK,11,2014,24875,12119,12756,1517,677,483,1094
PHA,12,2014,43499,22202,21297,3696,1769,947,1419
STC,12,2014,2774,1447,1327,508,94,76,163
STC,12,2014,3551,1856,1695,396,59,54,183
STC,12,2014,8959,4390,4569,663,127,141,425
STC,12,2014,5477,2907,2570,723,284,291,293
STC,12,2014,3823,2025,1798,522,143,88,132
STC,12,2014,5773,3076,2697,524,142,126,327
STC,12,2014,3776,2068,1708,454,532,203,187
STC,12,2014,5029,2560,2469,541,105,192,236
STC,12,2014,3865,2078,1787,506,215,42,221
STC,12,2014,3941,2112,1829,370,47,21,175
STC,12,2014,7002,3238,3764,899,129,106,345
STC,12,2014,2704,1423,1281,292,21,7,152
JHC,12,2014,7032,3555,3477,999,382,418,479
JHC,12,2014,3670,1793,1877,587,85,142,152
JHC,12,2014,3887,1939,1948,933,49,83,219
JHC,12,2014,2689,1403,1286,507,89,138,156
JHC,12,2014,1910,813,1097,502,70,95,101
JHC,12,2014,3359,1598,1761,523,49,158,156
JHC,12,2014,5098,2620,2478,679,175,293,289
PLK,12,2014,2316,1192,1124,392,88,99,103
PLK,12,2014,3808,1826,1982,755,125,180,181
PLK,12,2014,7212,3855,3357,867,433,469,428
PLK,12,2014,2169,1141,1028,336,53,147,141
PLK,12,2014,2906,1531,1375,425,31,38,183
PLK,12,2014,1520,824,696,225,34,17,75
PLK,12,2014,2710,1250,1460,505,45,44,112
KVK,12,2014,4165,1998,2167,578,127,36,147
KVK,12,2014,6806,3170,3636,701,146,276,323
KVK,12,2014,6319,3097,3222,505,52,125,314
ULK,12,2014,9359,4491,4868,934,97,91,453
ULK,12,2014,9757,5040,4717,749,197,186,398
ULK,12,2014,7353,3730,3623,762,223,108,313
ULK,12,2014,6166,2967,3199,655,90,156,284
ULK,12,2014,9942,5299,4643,672,94,135,419
ULK,12,2014,8114,4140,3974,687,173,213,288
ULK,12,2014,10133,4727,5406,609,159,106,422
LBK,12,2014,5727,3122,2605,659,114,177,323
LBK,12,2014,4353,2240,2113,418,112,88,254
LBK,12,2014,9530,5082,4448,910,433,435,443
LBK,12,2014,3886,1873,2013,557,64,50,225
HKK,12,2014,7636,3607,4029,955,264,401,489
HKK,12,2014,2927,1456,1471,538,70,68,187
HKK,12,2014,4537,2135,2402,734,130,153,228
HKK,12,2014,2534,1357,1177,488,84,74,154
HKK,12,2014,6232,3019,3213,830,219,158,336
PAK,12,2014,5027,2331,2696,1002,118,116,330
PAK,12,2014,5739,2990,2749,850,271,404,336
PAK,12,2014,5727,2772,2955,860,177,278,362
PAK,12,2014,5445,2690,2755,773,207,331,315
VYS,12,2014,4239,2168,2071,755,77,129,242
VYS,12,2014,5438,2568,2870,933,207,264,379
VYS,12,2014,2383,1156,1227,527,55,205,114
VYS,12,2014,7418,3776,3642,1149,94,104,468
VYS,12,2014,6054,2970,3084,934,103,105,407
JHM,12,2014,4930,2537,2393,592,79,91,331
JHM,12,2014,22501,11539,10962,1512,738,1314,1057
JHM,12,2014,9023,4606,4417,967,215,96,599
JHM,12,2014,6152,2965,3187,997,145,168,425
JHM,12,2014,11397,5163,6234,1666,271,185,604
JHM,12,2014,3816,1880,1936,532,85,63,258
JHM,12,2014,8384,4226,4158,1364,64,127,490
OLK,12,2014,3046,1389,1657,533,38,36,127
OLK,12,2014,13631,6503,7128,1628,399,505,780
OLK,12,2014,5508,2945,2563,710,145,129,303
OLK,12,2014,9248,4436,4812,1187,196,116,525
OLK,12,2014,7557,3549,4008,1026,346,369,369
ZLK,12,2014,6376,3026,3350,761,121,147,388
ZLK,12,2014,6249,3148,3101,943,150,157,385
ZLK,12,2014,8320,3776,4544,1261,198,119,460
ZLK,12,2014,8494,4316,4178,1123,273,86,508
MSK,12,2014,9085,4396,4689,1164,77,119,411
MSK,12,2014,10236,4888,5348,1281,306,321,609
MSK,12,2014,21701,10679,11022,1380,308,213,896
MSK,12,2014,7516,3551,3965,1052,259,279,332
MSK,12,2014,10229,4634,5595,1387,140,142,597
MSK,12,2014,25110,12097,13013,1665,364,738,1064
PHA,1,2015,43978,22334,21644,5626,1939,2344,1370
STC,1,2015,2958,1489,1469,617,160,84,164
STC,1,2015,3685,1910,1775,517,146,129,175
STC,1,2015,8959,4372,4587,869,305,206,410
STC,1,2015,5715,2941,2774,808,244,273,286
STC,1,2015,3947,2002,1945,519,127,69,123
STC,1,2015,5985,3167,2818,766,307,149,326
STC,1,2015,3749,2013,1736,522,409,306,166
STC,1,2015,5187,2619,2568,667,139,308,236
STC,1,2015,3932,2088,1844,644,273,230,193
STC,1,2015,4018,2130,1888,526,74,201,173
STC,1,2015,7242,3264,3978,909,218,145,322
STC,1,2015,2837,1449,1388,390,48,112,152
JHC,1,2015,7428,3610,3818,1429,566,456,425
JHC,1,2015,3930,1856,2074,652,252,61,140
JHC,1,2015,4297,2009,2288,827,158,136,215
JHC,1,2015,2980,1470,1510,688,179,137,159
JHC,1,2015,2067,816,1251,390,130,60,99
JHC,1,2015,3556,1625,1931,570,144,87,147
JHC,1,2015,5408,2626,2782,840,363,222,285
PLK,1,2015,2492,1234,1258,456,164,182,101
PLK,1,2015,3919,1790,2129,630,213,142,161
PLK,1,2015,7338,3817,3521,1202,898,808,390
PLK,1,2015,2239,1126,1113,363,57,26,138
PLK,1,2015,3047,1565,1482,549,89,58,158
PLK,1,2015,1580,839,741,294,195,40,66
PLK,1,2015,2768,1227,1541,377,93,164,104
KVK,1,2015,4337,2084,2253,691,232,192,142
KVK,1,2015,6961,3204,3757,847,316,371,302
KVK,1,2015,6489,3139,3350,714,98,73,304
ULK,1,2015,9718,4548,5170,1184,249,219,433
ULK,1,2015,10018,5086,4932,1069,240,304,399
ULK,1,2015,7652,3843,3809,895,291,257,316
ULK,1,2015,6324,3032,3292,712,290,228,276
ULK,1,2015,10008,5284,4724,847,213,551,412
ULK,1,2015,8278,4173,4105,943,224,170,258
ULK,1,2015,10142,4729,5413,760,227,217,422
LBK,1,2015,5752,3064,2688,764,356,198,317
LBK,1,2015,4362,2208,2154,566,206,179,230
LBK,1,2015,9709,5109,4600,1173,573,436,425
LBK,1,2015,3955,1855,2100,591,105,152,194
HKK,1,2015,7743,3539,4204,994,635,262,455
HKK,1,2015,3027,1430,1597,563,189,212,173
HKK,1,2015,4733,2150,2583,771,377,290,214
HKK,1,2015,2572,1329,1243,450,131,89,145
HKK,1,2015,6161,2894,3267,809,212,374,301
PAK,1,2015,5323,2358,2965,869,264,199,324
PAK,1,2015,5982,3012,2970,1064,602,261,312
PAK,1,2015,6038,2810,3228,895,272,327,354
PAK,1,2015,5639,2687,2952,879,363,394,307
VYS,1,2015,4407,2174,2233,558,179,117,215
VYS,1,2015,5640,2582,3058,829,246,201,359
VYS,1,2015,2517,1164,1353,459,177,75,106
VYS,1,2015,7604,3785,3819,825,142,132,449
VYS,1,2015,6263,2971,3292,777,303,267,382
JHM,1,2015,5050,2553,2497,583,179,151,329
JHM,1,2015,22426,11444,10982,2061,1438,852,988
JHM,1,2015,9206,4620,4586,1165,618,332,561
JHM,1,2015,6372,2976,3396,860,238,288,406
JHM,1,2015,11675,5105,6570,1380,348,447,567
JHM,1,2015,3957,1866,2091,606,112,118,239
JHM,1,2015,8927,4280,4647,1291,168,174,491
OLK,1,2015,3397,1478,1919,669,60,50,136
OLK,1,2015,14242,6571,7671,1880,812,557,759
OLK,1,2015,5823,3012,2811,828,304,140,272
OLK,1,2015,9434,4420,5014,948,327,213,486
OLK,1,2015,7659,3512,4147,887,349,341,345
ZLK,1,2015,6565,3028,3537,775,148,131,372
ZLK,1,2015,6521,3202,3319,1008,251,193,368
ZLK,1,2015,8417,3698,4719,1005,418,245,402
ZLK,1,2015,8744,4258,4486,1239,449,413,467
MSK,1,2015,9133,4261,4872,875,134,130,406
MSK,1,2015,10458,4949,5509,1308,503,456,575
MSK,1,2015,21939,10719,11220,1952,392,430,891
MSK,1,2015,7494,3473,4021,996,425,290,300
MSK,1,2015,10598,4641,5957,1322,258,323,574
MSK,1,2015,25559,12149,13410,2261,946,805,1041
PHA,2,2015,43876,22120,21756,4255,2233,1146,1660
STC,2,2015,2928,1490,1438,371,130,138,150
STC,2,2015,3618,1855,1763,337,143,121,171
STC,2,2015,8841,4298,4543,616,321,206,402
STC,2,2015,5690,2910,2780,503,237,142,292
STC,2,2015,3873,1987,1886,325,136,111,124
STC,2,2015,5876,3081,2795,429,216,79,296
STC,2,2015,3656,1972,1684,339,285,579,165
STC,2,2015,5152,2622,2530,411,300,427,230
STC,2,2015,3846,2054,1792,497,184,73,183
STC,2,2015,3969,2080,1889,370,74,28,173
STC,2,2015,7068,3174,3894,501,388,304,322
STC,2,2015,2812,1438,1374,213,145,48,154
JHC,2,2015,7399,3573,3826,796,543,321,420
JHC,2,2015,3928,1842,2086,338,279,232,130
JHC,2,2015,4247,1985,2262,398,141,76,217
JHC,2,2015,2926,1423,1503,307,248,93,149
JHC,2,2015,2052,830,1222,239,210,233,108
JHC,2,2015,3479,1590,1889,276,144,130,130
JHC,2,2015,5341,2597,2744,382,256,246,291
PLK,2,2015,2442,1235,1207,237,155,223,98
PLK,2,2015,3749,1725,2024,295,205,101,150
PLK,2,2015,7213,3752,3461,741,795,928,363
PLK,2,2015,2156,1096,1060,182,149,60,132
PLK,2,2015,2908,1499,1409,263,82,93,146
PLK,2,2015,1553,842,711,158,100,85,74
PLK,2,2015,2676,1186,1490,200,129,179,101
KVK,2,2015,4208,1988,2220,397,271,157,131
KVK,2,2015,6822,3120,3702,499,265,219,281
KVK,2,2015,6403,3113,3290,461,124,75,284
ULK,2,2015,9540,4480,5060,661,352,142,459
ULK,2,2015,9899,4999,4900,654,196,143,397
ULK,2,2015,7510,3783,3727,585,413,240,313
ULK,2,2015,6220,3014,3206,469,220,126,278
ULK,2,2015,9919,5260,4659,633,193,127,403
ULK,2,2015,8130,4112,4018,576,259,128,244
ULK,2,2015,10066,4717,5349,572,145,114,415
LBK,2,2015,5641,3017,2624,502,194,299,303
LBK,2,2015,4313,2182,2131,381,203,162,233
LBK,2,2015,9559,4982,4577,815,448,480,398
LBK,2,2015,3852,1781,2071,309,146,99,198
HKK,2,2015,7603,3460,4143,570,689,112,451
HKK,2,2015,2878,1368,1510,239,117,190,152
HKK,2,2015,4656,2085,2571,432,206,201,206
HKK,2,2015,2427,1267,1160,254,159,113,129
HKK,2,2015,6000,2831,3169,432,201,204,284
PAK,2,2015,5190,2295,2895,392,266,232,311
PAK,2,2015,5852,2956,2896,596,413,373,320
PAK,2,2015,5996,2780,3216,458,271,187,373
PAK,2,2015,5483,2601,2882,473,408,315,298
VYS,2,2015,4330,2132,2198,336,152,145,225
VYS,2,2015,5543,2545,2998,463,292,262,347
VYS,2,2015,2486,1168,1318,242,136,36,106
VYS,2,2015,7523,3724,3799,506,144,94,451
VYS,2,2015,6166,2926,3240,456,382,257,384
JHM,2,2015,5047,2570,2477,441,182,130,340
JHM,2,2015,22065,11257,10808,1534,1436,1167,974
JHM,2,2015,9034,4488,4546,755,290,130,573
JHM,2,2015,6255,2911,3344,478,342,277,404
JHM,2,2015,11383,4976,6407,681,437,256,559
JHM,2,2015,3867,1843,2024,341,81,72,229
JHM,2,2015,8809,4178,4631,664,173,101,474
OLK,2,2015,3405,1470,1935,269,46,40,138
OLK,2,2015,14063,6492,7571,997,729,440,746
OLK,2,2015,5640,2895,2745,423,379,217,245
OLK,2,2015,9238,4328,4910,536,351,184,469
OLK,2,2015,7522,3396,4126,525,460,307,324
ZLK,2,2015,6484,2973,3511,456,233,148,351
ZLK,2,2015,6297,3111,3186,507,453,266,352
ZLK,2,2015,8372,3647,4725,602,347,277,398
ZLK,2,2015,8682,4175,4507,760,450,261,449
MSK,2,2015,8995,4178,4817,459,113,149,388
MSK,2,2015,10336,4864,5472,844,491,428,607
MSK,2,2015,21869,10687,11182,1340,310,279,884
MSK,2,2015,7310,3389,3921,568,496,203,317
MSK,2,2015,10513,4589,5924,687,409,215,592
MSK,2,2015,25442,12043,13399,1581,761,567,1123
PHA,3,2015,43125,21785,21340,4431,1980,1656,1773
STC,3,2015,2770,1428,1342,368,210,126,126
STC,3,2015,3492,1811,1681,336,151,68,160
STC,3,2015,8624,4217,4407,750,222,183,389
STC,3,2015,5370,2796,2574,558,339,303,274
STC,3,2015,3668,1885,1783,388,177,91,121
STC,3,2015,5722,3027,2695,469,129,170,276
STC,3,2015,3572,1932,1640,388,392,252,175
STC,3,2015,5021,2589,2432,466,625,165,219
STC,3,2015,3743,1969,1774,483,332,216,169
STC,3,2015,3865,2054,1811,395,92,43,174
STC,3,2015,6661,3088,3573,559,213,129,309
STC,3,2015,2641,1379,1262,194,103,137,132
JHC,3,2015,6841,3402,3439,767,767,548,388
JHC,3,2015,3618,1793,1825,256,248,150,115
JHC,3,2015,3811,1877,1934,342,200,142,199
JHC,3,2015,2661,1319,1342,337,183,276,125
JHC,3,2015,1887,794,1093,230,199,132,93
JHC,3,2015,3192,1508,1684,286,150,104,137
JHC,3,2015,5015,2502,2513,408,494,357,289
PLK,3,2015,2278,1191,1087,226,253,160,87
PLK,3,2015,3368,1629,1739,339,311,223,136
PLK,3,2015,6926,3645,3281,804,790,802,337
PLK,3,2015,2018,1039,979,184,92,58,120
PLK,3,2015,2702,1392,1310,257,215,75,135
PLK,3,2015,1449,798,651,177,71,112,68
PLK,3,2015,2469,1150,1319,230,165,141,94
KVK,3,2015,3980,1876,2104,444,301,167,122
KVK,3,2015,6634,3062,3572,619,418,287,275
KVK,3,2015,6171,3037,3134,486,161,68,277
ULK,3,2015,9109,4321,4788,633,296,354,406
ULK,3,2015,9573,4882,4691,730,271,236,370
ULK,3,2015,7194,3657,3537,544,344,318,309
ULK,3,2015,6038,2956,3082,575,290,201,259
ULK,3,2015,9863,5224,4639,815,233,270,403
ULK,3,2015,7904,4038,3866,714,364,177,245
ULK,3,2015,9893,4661,5232,703,257,285,381
LBK,3,2015,5325,2888,2437,611,381,213,283
LBK,3,2015,4215,2134,2081,443,143,241,237
LBK,3,2015,9266,4837,4429,1022,695,532,381
LBK,3,2015,3746,1757,1989,353,167,151,193
HKK,3,2015,7312,3421,3891,626,573,84,464
HKK,3,2015,2652,1300,1352,295,131,109,156
HKK,3,2015,4387,2030,2357,434,246,270,205
HKK,3,2015,2278,1202,1076,267,134,160,122
HKK,3,2015,5811,2783,3028,554,314,269,284
PAK,3,2015,4688,2184,2504,452,371,194,281
PAK,3,2015,5632,2844,2788,728,734,571,323
PAK,3,2015,5513,2624,2889,388,316,254,333
PAK,3,2015,5215,2495,2720,590,494,437,287
VYS,3,2015,4058,2064,1994,297,282,191,208
VYS,3,2015,5194,2480,2714,453,397,333,328
VYS,3,2015,2326,1133,1193,221,236,97,116
VYS,3,2015,7078,3585,3493,451,264,116,427
VYS,3,2015,5797,2828,2969,456,288,239,371
JHM,3,2015,4842,2488,2354,414,215,179,332
JHM,3,2015,21690,11125,10565,1759,1548,1393,958
JHM,3,2015,8721,4382,4339,838,489,467,577
JHM,3,2015,5901,2769,3132,553,490,308,395
JHM,3,2015,10812,4840,5972,771,433,340,528
JHM,3,2015,3667,1754,1913,358,190,115,212
JHM,3,2015,8225,4008,4217,620,351,187,435
OLK,3,2015,3196,1411,1785,260,75,41,142
OLK,3,2015,13374,6280,7094,1068,1138,748,707
OLK,3,2015,5212,2732,2480,472,464,442,220
OLK,3,2015,8728,4165,4563,568,467,524,455
OLK,3,2015,7132,3283,3849,511,301,275,309
ZLK,3,2015,6219,2889,3330,453,222,195,350
ZLK,3,2015,5950,3025,2925,562,274,284,329
ZLK,3,2015,7986,3513,4473,580,530,363,372
ZLK,3,2015,8181,4002,4179,619,579,397,417
MSK,3,2015,8653,4109,4544,480,154,127,369
MSK,3,2015,9907,4728,5179,912,772,601,584
MSK,3,2015,21612,10515,11097,1475,437,290,837
MSK,3,2015,7018,3258,3760,663,790,436,312
MSK,3,2015,9963,4464,5499,727,465,218,574
MSK,3,2015,24965,11844,13121,1639,991,927,1097
PHA,4,2015,42038,21406,20632,4172,1367,1206,1652
STC,4,2015,2464,1304,1160,390,157,64,113
STC,4,2015,3382,1777,1605,343,260,145,149
STC,4,2015,8374,4108,4266,760,223,279,362
STC,4,2015,5003,2663,2340,486,354,234,262
STC,4,2015,3239,1714,1525,335,154,93,105
STC,4,2015,5440,2898,2542,481,208,64,265
STC,4,2015,3448,1891,1557,362,502,420,166
STC,4,2015,4756,2505,2251,466,317,317,213
STC,4,2015,3584,1907,1677,481,436,149,165
STC,4,2015,3734,1998,1736,416,127,131,162
STC,4,2015,6246,2983,3263,524,166,105,288
STC,4,2015,2430,1311,1119,205,83,76,126
JHC,4,2015,6414,3306,3108,890,693,549,365
JHC,4,2015,3252,1667,1585,303,310,123,109
JHC,4,2015,3117,1648,1469,427,174,123,188
JHC,4,2015,2242,1176,1066,332,192,134,123
JHC,4,2015,1558,724,834,213,175,119,82
JHC,4,2015,2836,1419,1417,282,183,143,115
JHC,4,2015,4578,2382,2196,418,370,325,244
PLK,4,2015,2087,1145,942,216,202,96,86
PLK,4,2015,2918,1518,1400,352,217,160,126
PLK,4,2015,6660,3572,3088,821,804,864,321
PLK,4,2015,1895,1009,886,213,111,54,104
PLK,4,2015,2474,1323,1151,302,179,66,130
PLK,4,2015,1340,763,577,175,226,86,64
PLK,4,2015,2276,1116,1160,269,155,110,94
KVK,4,2015,3757,1793,1964,498,261,301,106
KVK,4,2015,6334,2981,3353,589,359,187,267
KVK,4,2015,5976,2990,2986,509,163,130,231
ULK,4,2015,8670,4150,4520,830,397,212,377
ULK,4,2015,9207,4677,4530,737,192,178,332
ULK,4,2015,6747,3469,3278,626,278,358,292
ULK,4,2015,5624,2797,2827,606,260,183,227
ULK,4,2015,9533,5058,4475,725,287,78,394
ULK,4,2015,7620,3895,3725,758,307,307,245
ULK,4,2015,9539,4522,5017,824,193,188,385
LBK,4,2015,4934,2715,2219,563,539,149,249
LBK,4,2015,4138,2125,2013,487,137,121,237
LBK,4,2015,9033,4768,4265,980,570,538,374
LBK,4,2015,3536,1741,1795,414,224,116,194
HKK,4,2015,6782,3252,3530,619,760,278,457
HKK,4,2015,2342,1216,1126,298,263,151,132
HKK,4,2015,3922,1942,1980,499,286,240,178
HKK,4,2015,2039,1121,918,322,156,103,108
HKK,4,2015,5421,2684,2737,628,377,296,268
PAK,4,2015,4036,2057,1979,453,385,275,250
PAK,4,2015,5139,2697,2442,699,515,350,298
PAK,4,2015,4706,2383,2323,414,336,133,287
PAK,4,2015,4795,2392,2403,576,423,444,266
VYS,4,2015,3612,1968,1644,323,246,158,193
VYS,4,2015,4638,2332,2306,491,452,294,282
VYS,4,2015,2011,1045,966,230,186,81,102
VYS,4,2015,6131,3232,2899,447,148,116,379
VYS,4,2015,5135,2636,2499,434,313,229,348
JHM,4,2015,4568,2394,2174,431,210,163,306
JHM,4,2015,21258,10977,10281,1808,1637,1493,899
JHM,4,2015,8191,4203,3988,837,439,394,556
JHM,4,2015,5084,2545,2539,575,541,337,343
JHM,4,2015,9993,4661,5332,799,449,449,470
JHM,4,2015,3319,1650,1669,352,182,101,184
JHM,4,2015,7179,3645,3534,679,318,260,394
OLK,4,2015,2717,1262,1455,296,62,40,142
OLK,4,2015,12444,6042,6402,1044,1035,631,661
OLK,4,2015,4665,2553,2112,434,311,342,202
OLK,4,2015,7997,3990,4007,548,543,267,411
OLK,4,2015,6451,3088,3363,596,379,261,279
ZLK,4,2015,5766,2799,2967,520,228,154,310
ZLK,4,2015,5442,2896,2546,575,359,165,316
ZLK,4,2015,7406,3387,4019,719,427,245,348
ZLK,4,2015,7573,3829,3744,763,649,321,404
MSK,4,2015,7974,3910,4064,595,173,119,340
MSK,4,2015,9169,4494,4675,954,670,568,515
MSK,4,2015,21024,10347,10677,1346,485,285,802
MSK,4,2015,6546,3127,3419,751,417,401,278
MSK,4,2015,9217,4298,4919,751,439,326,557
MSK,4,2015,24460,11750,12710,1772,973,891,1097
PHA,5,2015,40679,20909,19770,3511,1481,1120,1403
STC,5,2015,2306,1258,1048,352,181,172,101
STC,5,2015,3244,1724,1520,303,394,107,120
STC,5,2015,8218,4073,4145,619,240,170,336
STC,5,2015,4773,2605,2168,450,236,336,217
STC,5,2015,3066,1688,1378,347,264,102,97
STC,5,2015,5225,2811,2414,406,227,253,230
STC,5,2015,3311,1832,1479,310,411,276,134
STC,5,2015,4526,2430,2096,318,230,474,190
STC,5,2015,3375,1828,1547,387,313,162,145
STC,5,2015,3622,1954,1668,354,82,36,146
STC,5,2015,5894,2887,3007,429,208,157,246
STC,5,2015,2266,1251,1015,179,147,72,98
JHC,5,2015,5925,3125,2800,758,629,594,344
JHC,5,2015,2991,1557,1434,259,271,88,96
JHC,5,2015,2672,1478,1194,272,190,162,145
JHC,5,2015,1994,1096,898,262,200,90,95
JHC,5,2015,1337,642,695,175,126,101,76
JHC,5,2015,2603,1357,1246,240,190,192,109
JHC,5,2015,4215,2265,1950,320,372,328,210
PLK,5,2015,1960,1113,847,192,324,77,68
PLK,5,2015,2695,1403,1292,337,235,137,111
PLK,5,2015,6493,3510,2983,731,648,398,291
PLK,5,2015,1799,976,823,180,126,71,89
PLK,5,2015,2349,1255,1094,259,67,104,118
PLK,5,2015,1242,720,522,154,76,92,56
PLK,5,2015,2140,1084,1056,185,358,97,81
KVK,5,2015,3555,1710,1845,378,242,181,97
KVK,5,2015,6091,2889,3202,489,396,257,247
KVK,5,2015,5743,2927,2816,405,207,78,204
ULK,5,2015,8182,3985,4197,717,209,157,326
ULK,5,2015,8964,4597,4367,630,282,179,308
ULK,5,2015,6406,3340,3066,491,365,126,253
ULK,5,2015,5374,2699,2675,431,165,189,196
ULK,5,2015,9404,5015,4389,635,258,186,374
ULK,5,2015,7443,3857,3586,684,406,246,225
ULK,5,2015,9300,4447,4853,557,389,173,332
LBK,5,2015,4674,2614,2060,455,391,223,218
LBK,5,2015,3965,2085,1880,378,181,94,212
LBK,5,2015,8706,4679,4027,774,693,589,338
LBK,5,2015,3256,1665,1591,260,143,108,164
HKK,5,2015,6420,3143,3277,497,632,87,389
HKK,5,2015,2107,1139,968,275,157,85,118
HKK,5,2015,3593,1843,1750,366,305,280,159
HKK,5,2015,1979,1098,881,370,151,140,109
HKK,5,2015,4886,2522,2364,455,379,515,222
PAK,5,2015,3636,1956,1680,373,334,288,207
PAK,5,2015,4795,2558,2237,599,545,344,267
PAK,5,2015,4360,2291,2069,351,199,72,249
PAK,5,2015,4427,2275,2152,464,487,350,222
VYS,5,2015,3418,1905,1513,269,265,199,155
VYS,5,2015,4237,2192,2045,359,445,337,243
VYS,5,2015,1821,1022,799,218,159,111,103
VYS,5,2015,5699,3103,2596,424,257,186,318
VYS,5,2015,4773,2526,2247,388,246,136,321
JHM,5,2015,4249,2282,1967,318,332,252,271
JHM,5,2015,20747,10802,9945,1382,2038,1347,819
JHM,5,2015,7773,4090,3683,661,380,73,485
JHM,5,2015,4680,2446,2234,493,511,357,289
JHM,5,2015,9227,4463,4764,524,393,329,376
JHM,5,2015,3032,1564,1468,290,189,101,159
JHM,5,2015,6487,3403,3084,527,235,90,343
OLK,5,2015,2385,1168,1217,239,117,27,113
OLK,5,2015,11711,5819,5892,902,861,723,531
OLK,5,2015,4345,2409,1936,429,357,231,174
OLK,5,2015,7498,3840,3658,479,484,507,338
OLK,5,2015,5913,2896,3017,510,370,194,244
ZLK,5,2015,5391,2683,2708,398,248,187,270
ZLK,5,2015,5054,2779,2275,481,400,227,280
ZLK,5,2015,6804,3215,3589,515,525,333,296
ZLK,5,2015,7046,3705,3341,609,392,205,354
MSK,5,2015,7432,3742,3690,538,189,147,294
MSK,5,2015,8611,4351,4260,802,798,476,430
MSK,5,2015,20523,10081,10442,1222,444,314,690
MSK,5,2015,6127,3014,3113,621,459,293,231
MSK,5,2015,8609,4168,4441,611,429,225,473
MSK,5,2015,23911,11562,12349,1387,1036,770,971
PHA,6,2015,39764,20663,19101,4043,1453,812,1287
STC,6,2015,2244,1231,1013,349,146,174,103
STC,6,2015,3159,1713,1446,313,175,168,107
STC,6,2015,8092,4076,4016,647,309,212,320
STC,6,2015,4668,2584,2084,495,345,273,214
STC,6,2015,2946,1658,1288,331,285,234,87
STC,6,2015,5107,2796,2311,470,210,219,199
STC,6,2015,3181,1776,1405,338,695,557,129
STC,6,2015,4467,2423,2044,415,223,251,183
STC,6,2015,3277,1800,1477,496,401,173,129
STC,6,2015,3519,1900,1619,373,116,66,135
STC,6,2015,5754,2852,2902,552,180,131,206
STC,6,2015,2200,1241,959,202,88,71,88
JHC,6,2015,5637,3010,2627,777,661,576,320
JHC,6,2015,2793,1473,1320,266,210,120,78
JHC,6,2015,2501,1416,1085,332,182,144,123
JHC,6,2015,1930,1084,846,320,227,128,100
JHC,6,2015,1222,589,633,190,84,126,56
JHC,6,2015,2559,1364,1195,308,162,144,89
JHC,6,2015,4047,2195,1852,400,280,259,176
PLK,6,2015,1927,1106,821,194,213,132,65
PLK,6,2015,2637,1399,1238,353,214,236,118
PLK,6,2015,6282,3484,2798,726,708,515,288
PLK,6,2015,1786,970,816,210,84,127,91
PLK,6,2015,2291,1217,1074,264,97,48,115
PLK,6,2015,1219,714,505,167,137,172,52
PLK,6,2015,2102,1064,1038,241,92,276,68
KVK,6,2015,3410,1641,1769,412,219,220,92
KVK,6,2015,5887,2802,3085,461,472,350,199
KVK,6,2015,5587,2869,2718,467,100,82,187
ULK,6,2015,7905,3884,4021,691,336,228,300
ULK,6,2015,8814,4565,4249,754,256,219,290
ULK,6,2015,6197,3264,2933,508,321,440,215
ULK,6,2015,5252,2649,2603,494,225,233,179
ULK,6,2015,9191,4909,4282,643,291,274,338
ULK,6,2015,7207,3742,3465,628,441,309,209
ULK,6,2015,9112,4399,4713,618,354,478,309
LBK,6,2015,4455,2543,1912,460,307,280,181
LBK,6,2015,3799,2039,1760,342,194,100,184
LBK,6,2015,8517,4623,3894,788,787,545,319
LBK,6,2015,3134,1656,1478,302,223,180,138
HKK,6,2015,6198,3092,3106,598,849,1285,354
HKK,6,2015,2015,1128,887,296,163,130,118
HKK,6,2015,3398,1775,1623,417,293,312,163
HKK,6,2015,1879,1076,803,281,264,170,90
HKK,6,2015,4642,2458,2184,449,345,265,200
PAK,6,2015,3451,1876,1575,399,200,151,186
PAK,6,2015,4572,2511,2061,585,715,496,223
PAK,6,2015,4143,2221,1922,351,254,180,190
PAK,6,2015,4272,2229,2043,474,474,350,213
VYS,6,2015,3270,1855,1415,305,235,135,128
VYS,6,2015,4108,2142,1966,432,396,459,207
VYS,6,2015,1754,1012,742,241,80,192,82
VYS,6,2015,5550,3071,2479,475,177,134,248
VYS,6,2015,4612,2478,2134,421,221,264,258
JHM,6,2015,4080,2236,1844,377,240,203,209
JHM,6,2015,20466,10713,9753,1579,1935,2136,793
JHM,6,2015,7512,4040,3472,715,430,403,424
JHM,6,2015,4488,2395,2093,457,404,317,237
JHM,6,2015,8923,4392,4531,723,529,444,361
JHM,6,2015,2911,1534,1377,335,136,111,138
JHM,6,2015,6189,3297,2892,522,340,129,264
OLK,6,2015,2234,1135,1099,251,85,151,90
OLK,6,2015,11199,5620,5579,948,1249,1123,459
OLK,6,2015,4112,2286,1826,441,316,276,159
OLK,6,2015,7295,3798,3497,604,484,610,314
OLK,6,2015,5666,2826,2840,530,310,282,218
ZLK,6,2015,5187,2637,2550,437,222,193,262
ZLK,6,2015,4872,2747,2125,559,395,244,250
ZLK,6,2015,6536,3186,3350,621,390,393,261
ZLK,6,2015,6818,3638,3180,703,649,505,306
MSK,6,2015,7126,3651,3475,507,203,194,236
MSK,6,2015,8187,4204,3983,850,830,596,366
MSK,6,2015,20282,9987,10295,1413,571,359,594
MSK,6,2015,5825,2924,2901,622,604,382,196
MSK,6,2015,8323,4113,4210,686,394,358,383
MSK,6,2015,23522,11445,12077,1692,1278,667,896
PHA,7,2015,40707,21644,19063,5067,1682,1252,1350
STC,7,2015,2317,1309,1008,433,133,100,113
STC,7,2015,3189,1769,1420,388,198,148,117
STC,7,2015,8123,4170,3953,758,226,132,329
STC,7,2015,4720,2641,2079,577,290,279,235
STC,7,2015,3028,1744,1284,417,178,182,99
STC,7,2015,5138,2881,2257,508,207,60,213
STC,7,2015,3248,1853,1395,419,469,503,122
STC,7,2015,4528,2526,2002,513,188,201,196
STC,7,2015,3340,1868,1472,578,431,232,164
STC,7,2015,3589,1992,1597,453,103,15,155
STC,7,2015,5800,2945,2855,671,164,154,227
STC,7,2015,2164,1244,920,229,134,87,88
JHC,7,2015,5685,3097,2588,977,664,481,364
JHC,7,2015,2701,1477,1224,284,181,410,85
JHC,7,2015,2477,1462,1015,375,211,106,134
JHC,7,2015,1956,1148,808,367,237,119,124
JHC,7,2015,1222,614,608,224,100,72,55
JHC,7,2015,2651,1453,1198,370,149,123,124
JHC,7,2015,4098,2294,1804,486,227,329,199
PLK,7,2015,1941,1137,804,238,188,204,69
PLK,7,2015,2659,1449,1210,393,212,111,140
PLK,7,2015,6480,3684,2796,1001,594,557,346
PLK,7,2015,1782,998,784,234,76,31,96
PLK,7,2015,2357,1292,1065,348,305,127,111
PLK,7,2015,1266,753,513,202,79,43,59
PLK,7,2015,2145,1127,1018,275,141,77,67
KVK,7,2015,3366,1663,1703,417,225,150,82
KVK,7,2015,5814,2809,3005,575,346,208,190
KVK,7,2015,5505,2891,2614,473,72,72,181
ULK,7,2015,7955,4017,3938,821,208,221,298
ULK,7,2015,8782,4633,4149,935,285,173,308
ULK,7,2015,6106,3296,2810,654,327,403,227
ULK,7,2015,5222,2695,2527,522,273,276,193
ULK,7,2015,9219,5000,4219,791,236,237,347
ULK,7,2015,7065,3755,3310,628,338,356,214
ULK,7,2015,9062,4461,4601,693,150,145,300
LBK,7,2015,4322,2527,1795,528,313,375,194
LBK,7,2015,3864,2118,1746,466,206,122,193
LBK,7,2015,8682,4816,3866,1028,606,453,348
LBK,7,2015,3158,1699,1459,364,84,111,156
HKK,7,2015,6382,3267,3115,770,665,1107,365
HKK,7,2015,2061,1186,875,356,135,133,126
HKK,7,2015,3507,1874,1633,548,293,243,167
HKK,7,2015,1901,1152,749,360,151,210,112
HKK,7,2015,4701,2556,2145,615,360,242,200
PAK,7,2015,3581,2011,1570,592,200,219,215
PAK,7,2015,4873,2770,2103,915,977,469,260
PAK,7,2015,4378,2431,1947,631,206,546,224
PAK,7,2015,4450,2426,2024,684,426,840,227
VYS,7,2015,3364,1975,1389,449,108,175,157
VYS,7,2015,4231,2296,1935,628,293,453,243
VYS,7,2015,1827,1062,765,313,81,155,98
VYS,7,2015,5620,3212,2408,605,170,151,289
VYS,7,2015,4821,2675,2146,686,184,196,321
JHM,7,2015,4155,2366,1789,478,202,177,232
JHM,7,2015,20865,11113,9752,2093,1691,1799,839
JHM,7,2015,7684,4287,3397,1017,535,457,432
JHM,7,2015,4577,2466,2111,645,356,378,255
JHM,7,2015,8981,4560,4421,942,351,504,391
JHM,7,2015,2970,1631,1339,472,84,87,157
JHM,7,2015,6114,3326,2788,674,307,316,260
OLK,7,2015,2163,1126,1037,241,73,56,96
OLK,7,2015,11295,5772,5523,1284,915,1017,508
OLK,7,2015,4009,2296,1713,447,177,231,157
OLK,7,2015,7341,3884,3457,686,410,408,368
OLK,7,2015,5699,2934,2765,681,315,313,264
ZLK,7,2015,5339,2809,2530,674,199,201,303
ZLK,7,2015,4991,2870,2121,747,334,244,278
ZLK,7,2015,6669,3364,3305,814,503,356,318
ZLK,7,2015,6870,3758,3112,882,481,1062,343
MSK,7,2015,7058,3649,3409,580,144,154,250
MSK,7,2015,8302,4341,3961,1133,782,580,420
MSK,7,2015,20276,10131,10145,1508,453,446,642
MSK,7,2015,5881,3042,2839,829,532,431,250
MSK,7,2015,8397,4316,4081,922,365,346,439
MSK,7,2015,23575,11678,11897,1885,940,623,957
PHA,8,2015,40401,21543,18858,3768,1439,1217,1517
STC,8,2015,2328,1326,1002,342,126,166,138
STC,8,2015,3178,1778,1400,324,168,143,145
STC,8,2015,7955,4098,3857,611,328,225,347
STC,8,2015,4689,2628,2061,474,295,400,240
STC,8,2015,2985,1713,1272,304,149,174,108
STC,8,2015,5088,2846,2242,427,200,259,208
STC,8,2015,3241,1855,1386,349,511,310,123
STC,8,2015,4469,2496,1973,376,334,311,220
STC,8,2015,3222,1838,1384,405,274,589,164
STC,8,2015,3590,2014,1576,372,139,28,160
STC,8,2015,5759,2933,2826,502,136,140,266
STC,8,2015,2090,1223,867,189,360,199,92
JHC,8,2015,5530,3059,2471,697,537,447,396
JHC,8,2015,2674,1463,1211,265,185,65,105
JHC,8,2015,2380,1416,964,275,185,125,125
JHC,8,2015,1910,1102,808,252,193,153,130
JHC,8,2015,1208,625,583,193,252,39,67
JHC,8,2015,2604,1415,1189,269,152,72,144
JHC,8,2015,4069,2310,1759,410,332,221,220
PLK,8,2015,1925,1141,784,194,223,156,82
PLK,8,2015,2624,1447,1177,305,190,90,153
PLK,8,2015,6337,3625,2712,739,809,589,359
PLK,8,2015,1769,1011,758,205,164,124,110
PLK,8,2015,2332,1285,1047,246,143,52,114
PLK,8,2015,1238,750,488,143,126,53,62
PLK,8,2015,2138,1121,1017,230,231,96,79
KVK,8,2015,3300,1664,1636,350,239,156,84
KVK,8,2015,5739,2795,2944,490,340,377,199
KVK,8,2015,5453,2868,2585,492,174,101,177
ULK,8,2015,7746,3891,3855,548,249,269,302
ULK,8,2015,8621,4589,4032,686,286,291,333
ULK,8,2015,6010,3242,2768,567,279,111,255
ULK,8,2015,5092,2645,2447,463,231,87,206
ULK,8,2015,9053,4938,4115,618,304,227,341
ULK,8,2015,7083,3797,3286,773,355,236,222
ULK,8,2015,8906,4419,4487,512,229,199,306
LBK,8,2015,4254,2486,1768,430,250,319,198
LBK,8,2015,3830,2094,1736,369,157,135,206
LBK,8,2015,8698,4843,3855,908,597,313,369
LBK,8,2015,3133,1680,1453,290,213,126,170
HKK,8,2015,6380,3260,3120,598,699,1281,407
HKK,8,2015,1989,1144,845,245,217,128,130
HKK,8,2015,3486,1863,1623,418,271,304,189
HKK,8,2015,1875,1145,730,291,349,129,129
HKK,8,2015,4554,2489,2065,438,284,282,217
PAK,8,2015,3544,1991,1553,408,340,148,244
PAK,8,2015,4858,2726,2132,626,854,1051,292
PAK,8,2015,4343,2428,1915,449,378,95,254
PAK,8,2015,4395,2421,1974,491,439,261,260
VYS,8,2015,3334,1973,1361,308,153,112,181
VYS,8,2015,4140,2267,1873,429,419,303,264
VYS,8,2015,1831,1066,765,252,191,76,109
VYS,8,2015,5583,3181,2402,442,151,90,327
VYS,8,2015,4808,2674,2134,496,237,159,361
JHM,8,2015,4078,2323,1755,362,171,118,266
JHM,8,2015,20702,11059,9643,1541,1840,1447,871
JHM,8,2015,7603,4225,3378,780,529,654,492
JHM,8,2015,4517,2430,2087,486,429,422,297
JHM,8,2015,8919,4531,4388,771,502,254,483
JHM,8,2015,2963,1646,1317,344,194,77,201
JHM,8,2015,6200,3411,2789,624,250,252,298
OLK,8,2015,2138,1112,1026,231,84,51,103
OLK,8,2015,11049,5698,5351,1031,986,863,532
OLK,8,2015,3984,2322,1662,403,204,201,190
OLK,8,2015,7269,3885,3384,570,443,215,408
OLK,8,2015,5589,2872,2717,482,268,168,292
ZLK,8,2015,5218,2793,2425,437,215,173,301
ZLK,8,2015,4991,2885,2106,550,331,312,331
ZLK,8,2015,6506,3269,3237,584,490,505,363
ZLK,8,2015,6777,3716,3061,710,632,338,396
MSK,8,2015,6892,3582,3310,464,231,115,259
MSK,8,2015,8138,4320,3818,942,783,924,486
MSK,8,2015,20074,10027,10047,1376,657,542,726
MSK,8,2015,5765,2970,2795,674,634,348,291
MSK,8,2015,8182,4247,3935,647,362,288,461
MSK,8,2015,23341,11645,11696,1506,1102,614,980
PHA,9,2015,39165,20637,18528,4849,2012,1051,1692
STC,9,2015,2361,1304,1057,549,156,124,174
STC,9,2015,3181,1743,1438,483,210,67,210
STC,9,2015,7764,4013,3751,789,314,285,399
STC,9,2015,4654,2584,2070,709,360,274,326
STC,9,2015,2932,1656,1276,486,194,176,139
STC,9,2015,4975,2754,2221,559,180,217,247
STC,9,2015,3195,1819,1376,522,639,526,195
STC,9,2015,4345,2396,1949,596,284,236,244
STC,9,2015,3159,1765,1394,612,352,169,233
STC,9,2015,3558,1956,1602,524,124,74,204
STC,9,2015,5670,2881,2789,702,184,132,333
STC,9,2015,2060,1177,883,308,163,62,133
JHC,9,2015,5263,2914,2349,1049,577,679,392
JHC,9,2015,2626,1435,1191,361,164,207,127
JHC,9,2015,2312,1351,961,450,170,147,159
JHC,9,2015,1864,1043,821,391,160,184,153
JHC,9,2015,1223,616,607,280,119,141,94
JHC,9,2015,2512,1353,1159,394,175,200,153
JHC,9,2015,3947,2219,1728,544,280,287,267
PLK,9,2015,1919,1122,797,297,224,195,117
PLK,9,2015,2504,1360,1144,426,207,279,168
PLK,9,2015,6024,3424,2600,958,660,617,386
PLK,9,2015,1733,968,765,283,107,75,132
PLK,9,2015,2208,1219,989,391,91,54,154
PLK,9,2015,1249,729,520,281,90,143,93
PLK,9,2015,2083,1050,1033,292,549,429,117
KVK,9,2015,3261,1656,1605,509,339,247,101
KVK,9,2015,5664,2735,2929,698,434,224,266
KVK,9,2015,5355,2800,2555,614,112,177,233
ULK,9,2015,7627,3830,3797,936,331,293,386
ULK,9,2015,8540,4489,4051,970,412,303,376
ULK,9,2015,5940,3210,2730,800,274,316,327
ULK,9,2015,5024,2593,2431,651,187,234,269
ULK,9,2015,8915,4849,4066,872,349,252,404
ULK,9,2015,7052,3739,3313,800,351,312,336
ULK,9,2015,8684,4276,4408,784,281,256,350
LBK,9,2015,4176,2420,1756,674,251,290,246
LBK,9,2015,3798,2070,1728,553,121,142,239
LBK,9,2015,8558,4758,3800,1130,669,712,445
LBK,9,2015,3120,1651,1469,480,242,121,219
HKK,9,2015,6235,3157,3078,812,752,690,456
HKK,9,2015,1971,1114,857,421,121,76,193
HKK,9,2015,3466,1834,1632,641,293,196,273
HKK,9,2015,1699,1026,673,357,444,370,156
HKK,9,2015,4481,2416,2065,684,475,255,330
PAK,9,2015,3463,1881,1582,645,298,268,321
PAK,9,2015,4730,2607,2123,895,534,300,360
PAK,9,2015,4151,2239,1912,615,249,163,305
PAK,9,2015,4238,2302,1936,731,518,299,300
VYS,9,2015,3254,1909,1345,471,174,187,264
VYS,9,2015,3979,2091,1888,617,514,389,299
VYS,9,2015,1759,999,760,319,122,50,131
VYS,9,2015,5519,3110,2409,700,185,247,411
VYS,9,2015,4709,2542,2167,637,281,212,412
JHM,9,2015,3943,2217,1726,567,182,254,284
JHM,9,2015,20132,10663,9469,2082,1920,1868,926
JHM,9,2015,7368,4040,3328,1105,501,149,605
JHM,9,2015,4513,2382,2131,789,444,396,395
JHM,9,2015,8817,4432,4385,1117,380,378,616
JHM,9,2015,2921,1564,1357,530,136,143,277
JHM,9,2015,5997,3260,2737,806,214,190,418
OLK,9,2015,2129,1118,1011,325,104,91,132
OLK,9,2015,10757,5515,5242,1463,1050,1161,677
OLK,9,2015,3955,2274,1681,619,647,389,265
OLK,9,2015,7262,3851,3411,888,658,383,535
OLK,9,2015,5509,2789,2720,790,283,406,351
ZLK,9,2015,5115,2705,2410,696,283,233,342
ZLK,9,2015,4846,2779,2067,694,309,225,409
ZLK,9,2015,6322,3123,3199,870,575,444,461
ZLK,9,2015,6539,3567,2972,956,501,349,473
MSK,9,2015,7005,3639,3366,835,161,227,361
MSK,9,2015,8052,4241,3811,1306,789,813,655
MSK,9,2015,19940,9933,10007,1948,591,691,871
MSK,9,2015,5641,2902,2739,863,1753,1726,382
MSK,9,2015,8198,4154,4044,1098,507,402,590
MSK,9,2015,23077,11477,11600,2144,986,698,1119
PHA,10,2015,37876,19994,17882,4099,1853,865,1681
STC,10,2015,2272,1259,1013,391,133,208,163
STC,10,2015,3067,1681,1386,337,154,140,208
STC,10,2015,7541,3890,3651,663,206,251,398
STC,10,2015,4503,2495,2008,512,574,349,301
STC,10,2015,2827,1583,1244,326,102,63,134
STC,10,2015,4908,2701,2207,505,222,215,257
STC,10,2015,3035,1730,1305,354,647,530,165
STC,10,2015,4209,2305,1904,412,649,419,247
STC,10,2015,3113,1731,1382,498,525,426,233
STC,10,2015,3462,1878,1584,428,184,98,198
STC,10,2015,5531,2848,2683,534,158,164,326
STC,10,2015,2016,1139,877,237,47,66,126
JHC,10,2015,5134,2806,2328,899,717,692,376
JHC,10,2015,2655,1476,1179,366,155,168,127
JHC,10,2015,2333,1347,986,444,137,139,148
JHC,10,2015,1846,1020,826,352,176,250,147
JHC,10,2015,1202,622,580,207,93,139,89
JHC,10,2015,2403,1303,1100,292,167,220,135
JHC,10,2015,3818,2134,1684,431,203,268,235
PLK,10,2015,1899,1095,804,230,140,228,120
PLK,10,2015,2403,1285,1118,368,143,209,170
PLK,10,2015,5797,3294,2503,814,721,679,373
PLK,10,2015,1718,952,766,263,83,71,132
PLK,10,2015,2099,1157,942,264,154,88,157
PLK,10,2015,1231,716,515,188,102,67,90
PLK,10,2015,2002,1011,991,207,142,206,96
KVK,10,2015,3244,1631,1613,452,271,224,118
KVK,10,2015,5656,2739,2917,643,349,495,265
KVK,10,2015,5438,2807,2631,683,67,110,242
ULK,10,2015,7518,3822,3696,743,232,246,369
ULK,10,2015,8334,4376,3958,751,314,306,365
ULK,10,2015,5698,3091,2607,553,344,637,311
ULK,10,2015,4851,2495,2356,488,298,146,256
ULK,10,2015,8737,4742,3995,710,332,498,396
ULK,10,2015,6860,3665,3195,651,279,318,337
ULK,10,2015,8657,4206,4451,684,292,278,355
LBK,10,2015,4097,2358,1739,555,378,667,222
LBK,10,2015,3707,2028,1679,425,156,105,242
LBK,10,2015,8310,4560,3750,897,860,677,451
LBK,10,2015,3013,1583,1430,349,151,177,188
HKK,10,2015,6091,3050,3041,670,579,805,467
HKK,10,2015,1884,1055,829,292,182,428,172
HKK,10,2015,3357,1762,1595,462,290,330,234
HKK,10,2015,1551,946,605,285,195,207,131
HKK,10,2015,4355,2374,1981,539,398,486,297
PAK,10,2015,3355,1805,1550,453,244,378,281
PAK,10,2015,4674,2551,2123,778,609,600,364
PAK,10,2015,3960,2120,1840,398,262,163,263
PAK,10,2015,3984,2150,1834,485,393,385,288
VYS,10,2015,3128,1824,1304,317,124,140,250
VYS,10,2015,3876,2017,1859,461,364,403,293
VYS,10,2015,1672,951,721,212,69,142,114
VYS,10,2015,5436,3030,2406,529,295,327,399
VYS,10,2015,4578,2471,2107,455,239,263,377
JHM,10,2015,3836,2153,1683,396,104,164,233
JHM,10,2015,19665,10417,9248,1546,2002,1753,880
JHM,10,2015,6990,3806,3184,702,486,681,527
JHM,10,2015,4353,2321,2032,504,319,386,366
JHM,10,2015,8581,4311,4270,707,413,401,565
JHM,10,2015,2801,1488,1313,345,107,191,240
JHM,10,2015,6007,3246,2761,689,173,419,410
OLK,10,2015,2097,1111,986,269,160,160,102
OLK,10,2015,10477,5374,5103,1085,826,697,654
OLK,10,2015,3831,2200,1631,433,269,348,235
OLK,10,2015,6937,3670,3267,526,580,479,463
OLK,10,2015,5254,2640,2614,516,324,349,322
ZLK,10,2015,4951,2619,2332,447,287,285,331
ZLK,10,2015,4627,2631,1996,539,304,242,385
ZLK,10,2015,6177,3056,3121,621,403,314,448
ZLK,10,2015,6253,3408,2845,682,528,889,425
MSK,10,2015,6929,3624,3305,569,193,134,334
MSK,10,2015,7683,4000,3683,887,672,674,581
MSK,10,2015,19559,9682,9877,1398,409,503,832
MSK,10,2015,5491,2821,2670,741,687,982,368
MSK,10,2015,8098,4135,3963,757,379,623,574
MSK,10,2015,22914,11318,11596,1827,671,865,1084
PHA,11,2015,37127,19502,17625,4068,2012,1443,1597
STC,11,2015,2307,1283,1024,483,148,145,138
STC,11,2015,3009,1606,1403,381,263,146,183
STC,11,2015,7364,3782,3582,801,127,212,360
STC,11,2015,4653,2516,2137,760,203,308,269
STC,11,2015,3064,1684,1380,618,162,404,117
STC,11,2015,4992,2772,2220,611,289,307,231
STC,11,2015,2958,1674,1284,360,501,891,144
STC,11,2015,4235,2285,1950,541,270,309,220
STC,11,2015,3032,1679,1353,467,363,326,221
STC,11,2015,3333,1827,1506,369,83,44,182
STC,11,2015,5572,2787,2785,759,165,171,282
STC,11,2015,2036,1155,881,306,54,90,101
JHC,11,2015,5113,2768,2345,884,514,482,321
JHC,11,2015,2827,1530,1297,492,152,357,121
JHC,11,2015,2517,1427,1090,559,132,112,144
JHC,11,2015,1974,1073,901,537,146,157,123
JHC,11,2015,1365,660,705,407,81,117,80
JHC,11,2015,2472,1288,1184,391,144,86,117
JHC,11,2015,3868,2098,1770,507,239,194,209
PLK,11,2015,1973,1117,856,305,199,165,109
PLK,11,2015,2601,1356,1245,565,113,138,141
PLK,11,2015,5693,3204,2489,746,620,655,328
PLK,11,2015,1712,942,770,239,120,204,116
PLK,11,2015,2047,1138,909,315,47,38,124
PLK,11,2015,1217,680,537,187,86,129,77
PLK,11,2015,2029,1009,1020,276,114,77,84
KVK,11,2015,3338,1654,1684,642,189,222,118
KVK,11,2015,5720,2745,2975,763,291,310,236
KVK,11,2015,5489,2818,2671,605,114,69,221
ULK,11,2015,7637,3863,3774,910,284,271,367
ULK,11,2015,8161,4261,3900,808,280,363,318
ULK,11,2015,5641,3028,2613,715,287,129,273
ULK,11,2015,4842,2485,2357,653,142,171,216
ULK,11,2015,8651,4692,3959,851,318,210,399
ULK,11,2015,6751,3566,3185,745,364,366,314
ULK,11,2015,8483,4116,4367,734,226,318,344
LBK,11,2015,4036,2294,1742,615,764,309,212
LBK,11,2015,3577,1940,1637,361,148,136,219
LBK,11,2015,8192,4476,3716,934,621,766,419
LBK,11,2015,3060,1561,1499,443,146,135,173
HKK,11,2015,6086,3042,3044,725,571,502,438
HKK,11,2015,1920,1061,859,411,148,143,141
HKK,11,2015,3428,1724,1704,571,222,273,215
HKK,11,2015,1542,923,619,316,161,167,112
HKK,11,2015,4428,2367,2061,664,387,240,262
PAK,11,2015,3471,1824,1647,625,155,244,234
PAK,11,2015,4715,2528,2187,748,579,796,317
PAK,11,2015,4100,2140,1960,623,226,176,248
PAK,11,2015,3994,2109,1885,555,413,488,261
VYS,11,2015,3209,1839,1370,427,213,196,240
VYS,11,2015,3881,1990,1891,549,341,353,245
VYS,11,2015,1708,938,770,321,145,169,99
VYS,11,2015,5630,3079,2551,712,112,144,355
VYS,11,2015,4518,2368,2150,560,212,255,319
JHM,11,2015,3857,2128,1729,462,178,159,209
JHM,11,2015,19381,10219,9162,1579,1489,1844,850
JHM,11,2015,6940,3731,3209,860,307,434,480
JHM,11,2015,4534,2351,2183,786,293,347,334
JHM,11,2015,8707,4296,4411,992,259,423,512
JHM,11,2015,2840,1481,1359,433,113,129,214
JHM,11,2015,6370,3434,2936,958,155,246,382
OLK,11,2015,2355,1208,1147,553,86,109,99
OLK,11,2015,10430,5257,5173,1241,674,1048,593
OLK,11,2015,3775,2132,1643,481,180,233,193
OLK,11,2015,6838,3588,3250,656,354,448,424
OLK,11,2015,5361,2618,2743,773,219,259,281
ZLK,11,2015,5008,2576,2432,594,200,280,294
ZLK,11,2015,4650,2577,2073,659,234,350,345
ZLK,11,2015,6314,3064,3250,834,482,577,393
ZLK,11,2015,6394,3395,2999,932,348,296,413
MSK,11,2015,7124,3661,3463,802,158,173,322
MSK,11,2015,7719,3951,3768,1059,471,586,509
MSK,11,2015,19408,9533,9875,1454,376,460,791
MSK,11,2015,5316,2679,2637,751,584,412,310
MSK,11,2015,8135,4072,4063,914,330,422,532
MSK,11,2015,22610,11097,11513,1721,772,1080,1007
PHA,12,2015,37218,19429,17789,3450,1065,814,1495
STC,12,2015,2465,1284,1181,454,66,176,127
STC,12,2015,3072,1625,1447,381,96,71,175
STC,12,2015,7495,3805,3690,725,253,214,331
STC,12,2015,4860,2551,2309,638,346,394,255
STC,12,2015,3249,1726,1523,463,158,91,105
STC,12,2015,5079,2793,2286,509,159,176,235
STC,12,2015,3022,1678,1344,354,378,530,135
STC,12,2015,4325,2283,2042,468,405,277,217
STC,12,2015,3091,1720,1371,431,179,60,200
STC,12,2015,3335,1800,1535,345,59,25,173
STC,12,2015,5955,2855,3100,846,74,110,275
STC,12,2015,2154,1174,980,314,10,5,91
JHC,12,2015,5580,2868,2712,1021,484,270,337
JHC,12,2015,3140,1623,1517,550,123,55,122
JHC,12,2015,3070,1511,1559,832,118,172,146
JHC,12,2015,2161,1080,1081,515,72,161,106
JHC,12,2015,1652,685,967,465,35,10,86
JHC,12,2015,2776,1355,1421,501,85,127,116
JHC,12,2015,4197,2149,2048,644,140,312,199
PLK,12,2015,2177,1146,1031,375,96,171,99
PLK,12,2015,2951,1375,1576,668,197,121,141
PLK,12,2015,5877,3260,2617,806,464,382,306
PLK,12,2015,1788,944,844,246,35,9,113
PLK,12,2015,2238,1184,1054,384,161,18,114
PLK,12,2015,1292,715,577,202,270,54,72
PLK,12,2015,2264,1051,1213,410,95,85,89
KVK,12,2015,3555,1716,1839,559,247,297,122
KVK,12,2015,5796,2723,3073,582,202,140,229
KVK,12,2015,5545,2831,2714,511,55,68,223
ULK,12,2015,7874,3877,3997,857,152,189,342
ULK,12,2015,8259,4267,3992,726,150,270,316
ULK,12,2015,5849,3034,2815,740,149,334,252
ULK,12,2015,5007,2465,2542,622,97,125,211
ULK,12,2015,8564,4597,3967,561,181,174,399
ULK,12,2015,6760,3554,3206,656,171,262,284
ULK,12,2015,8465,4060,4405,569,144,84,330
LBK,12,2015,4271,2376,1895,666,178,235,211
LBK,12,2015,3662,1955,1707,397,108,72,207
LBK,12,2015,8332,4451,3881,856,594,712,388
LBK,12,2015,3242,1540,1702,487,139,212,168
HKK,12,2015,6394,3033,3361,860,385,776,432
HKK,12,2015,2156,1110,1046,466,148,141,128
HKK,12,2015,3766,1748,2018,652,164,190,207
HKK,12,2015,1607,919,688,320,192,173,93
HKK,12,2015,4651,2346,2305,692,215,494,254
PAK,12,2015,4095,1918,2177,990,175,142,221
PAK,12,2015,4966,2598,2368,812,454,631,286
PAK,12,2015,4720,2265,2455,927,189,169,256
PAK,12,2015,4294,2122,2172,705,263,311,245
VYS,12,2015,3629,1903,1726,705,64,144,216
VYS,12,2015,4382,2052,2330,858,207,371,238
VYS,12,2015,1944,969,975,451,83,161,86
VYS,12,2015,6336,3222,3114,1109,155,51,346
VYS,12,2015,4977,2412,2565,810,106,272,319
JHM,12,2015,4085,2191,1894,541,116,109,218
JHM,12,2015,19526,10214,9312,1466,1340,1506,827
JHM,12,2015,7352,3843,3509,981,179,766,466
JHM,12,2015,5144,2512,2632,968,187,175,313
JHM,12,2015,9709,4511,5198,1526,238,229,511
JHM,12,2015,3027,1488,1539,475,83,103,209
JHM,12,2015,7189,3621,3568,1244,113,166,373
OLK,12,2015,2661,1225,1436,540,78,79,99
OLK,12,2015,11221,5334,5887,1708,369,376,555
OLK,12,2015,4056,2190,1866,589,134,127,196
OLK,12,2015,7387,3622,3765,1104,238,435,398
OLK,12,2015,5733,2650,3083,829,155,106,259
ZLK,12,2015,5307,2580,2727,725,224,161,297
ZLK,12,2015,5060,2594,2466,822,167,178,337
ZLK,12,2015,6798,3130,3668,972,238,201,380
ZLK,12,2015,6709,3433,3276,927,274,159,391
MSK,12,2015,7652,3688,3964,1008,118,151,324
MSK,12,2015,8119,4011,4108,1138,346,537,471
MSK,12,2015,19501,9480,10021,1261,189,290,762
MSK,12,2015,5679,2738,2941,884,1224,1292,285
MSK,12,2015,8868,4061,4807,1342,219,322,520
MSK,12,2015,22754,11101,11653,1610,509,674,963
PHA,1,2016,37651,19634,18017,4842,1869,1227,1440
STC,1,2016,2606,1320,1286,545,210,371,114
STC,1,2016,3074,1593,1481,404,203,206,157
STC,1,2016,7549,3806,3743,801,219,198,329
STC,1,2016,4943,2568,2375,677,370,334,258
STC,1,2016,3417,1742,1675,503,193,59,101
STC,1,2016,5158,2782,2376,584,276,193,223
STC,1,2016,3052,1672,1380,461,380,239,117
STC,1,2016,4326,2243,2083,507,746,909,184
STC,1,2016,3152,1731,1421,609,414,247,182
STC,1,2016,3466,1858,1608,471,168,64,159
STC,1,2016,6255,2938,3317,868,366,256,253
STC,1,2016,2221,1174,1047,305,231,138,99
JHC,1,2016,6066,2966,3100,1361,489,605,302
JHC,1,2016,3394,1635,1759,569,145,98,114
JHC,1,2016,3419,1577,1842,738,132,74,151
JHC,1,2016,2497,1184,1313,638,216,103,112
JHC,1,2016,1843,715,1128,407,109,55,89
JHC,1,2016,2946,1359,1587,532,229,179,110
JHC,1,2016,4542,2206,2336,781,534,359,210
PLK,1,2016,2279,1156,1123,369,127,129,97
PLK,1,2016,3165,1392,1773,634,197,288,120
PLK,1,2016,5970,3263,2707,982,566,457,291
PLK,1,2016,1904,976,928,361,142,42,100
PLK,1,2016,2383,1206,1177,481,46,46,99
PLK,1,2016,1283,693,590,186,83,161,65
PLK,1,2016,2372,1060,1312,364,130,164,89
KVK,1,2016,3656,1699,1957,540,241,318,116
KVK,1,2016,5986,2768,3218,774,333,233,221
KVK,1,2016,5692,2845,2847,648,105,129,232
ULK,1,2016,8226,4009,4217,1088,419,231,318
ULK,1,2016,8434,4322,4112,895,256,330,311
ULK,1,2016,6160,3096,3064,858,396,60,267
ULK,1,2016,5188,2514,2674,622,292,318,235
ULK,1,2016,8744,4633,4111,904,274,397,385
ULK,1,2016,6968,3618,3350,812,343,324,275
ULK,1,2016,8524,4048,4476,806,358,282,338
LBK,1,2016,4409,2375,2034,726,446,369,203
LBK,1,2016,3802,1981,1821,551,128,263,208
LBK,1,2016,8438,4418,4020,1075,601,674,397
LBK,1,2016,3325,1508,1817,514,154,148,160
HKK,1,2016,6476,2946,3530,853,894,504,413
HKK,1,2016,2243,1102,1141,471,178,200,119
HKK,1,2016,3988,1777,2211,718,284,150,189
HKK,1,2016,1670,931,739,389,325,123,77
HKK,1,2016,4706,2282,2424,700,421,501,225
PAK,1,2016,4441,1969,2472,786,282,163,229
PAK,1,2016,5148,2628,2520,899,841,1020,271
PAK,1,2016,5053,2302,2751,860,232,254,263
PAK,1,2016,4595,2141,2454,884,493,370,221
VYS,1,2016,3802,1928,1874,535,148,101,191
VYS,1,2016,4565,2029,2536,708,335,279,230
VYS,1,2016,2083,975,1108,395,146,107,78
VYS,1,2016,6575,3198,3377,803,158,163,328
VYS,1,2016,5253,2426,2827,847,307,221,297
JHM,1,2016,4209,2176,2033,504,273,168,216
JHM,1,2016,19649,10189,9460,1999,2033,905,788
JHM,1,2016,7590,3861,3729,1101,785,366,438
JHM,1,2016,5364,2540,2824,819,456,603,297
JHM,1,2016,9965,4427,5538,1252,397,385,470
JHM,1,2016,3155,1495,1660,546,182,188,199
JHM,1,2016,7772,3662,4110,1276,180,236,363
OLK,1,2016,2866,1245,1621,466,148,59,94
OLK,1,2016,11668,5341,6327,1668,808,443,531
OLK,1,2016,4248,2225,2023,699,356,266,182
OLK,1,2016,7591,3621,3970,932,503,420,388
OLK,1,2016,5894,2637,3257,782,274,252,241
ZLK,1,2016,5513,2580,2933,764,260,161,293
ZLK,1,2016,5360,2636,2724,889,458,352,326
ZLK,1,2016,7075,3150,3925,986,306,305,363
ZLK,1,2016,6815,3309,3506,1053,545,421,361
MSK,1,2016,7735,3624,4111,789,280,163,323
MSK,1,2016,8306,4026,4280,1204,735,718,431
MSK,1,2016,19675,9494,10181,1674,387,548,727
MSK,1,2016,5773,2712,3061,845,523,526,272
MSK,1,2016,8994,3978,5016,1134,461,285,477
MSK,1,2016,23103,11210,11893,2069,893,986,933
PHA,2,2016,37389,19426,17963,4026,1950,875,1428
STC,2,2016,2525,1280,1245,363,127,158,116
STC,2,2016,3036,1545,1491,320,147,95,144
STC,2,2016,7498,3758,3740,661,351,186,327
STC,2,2016,4916,2522,2394,485,377,264,262
STC,2,2016,3361,1717,1644,285,142,231,102
STC,2,2016,5111,2748,2363,467,464,225,239
STC,2,2016,2952,1617,1335,326,532,262,115
STC,2,2016,4227,2191,2036,388,291,457,194
STC,2,2016,3084,1687,1397,489,415,75,172
STC,2,2016,3341,1762,1579,375,88,153,153
STC,2,2016,6182,2895,3287,522,284,152,268
STC,2,2016,2194,1167,1027,220,133,55,98
JHC,2,2016,5965,2909,3056,784,737,710,303
JHC,2,2016,3388,1639,1749,385,227,196,109
JHC,2,2016,3339,1538,1801,311,207,190,136
JHC,2,2016,2396,1139,1257,257,205,170,116
JHC,2,2016,1796,705,1091,233,76,80,99
JHC,2,2016,2918,1349,1569,291,247,133,112
JHC,2,2016,4506,2197,2309,433,337,196,215
PLK,2,2016,2209,1135,1074,235,208,157,84
PLK,2,2016,3048,1350,1698,307,269,148,110
PLK,2,2016,5817,3177,2640,745,551,564,283
PLK,2,2016,1852,942,910,181,123,85,91
PLK,2,2016,2313,1171,1142,255,81,34,96
PLK,2,2016,1229,680,549,142,82,147,65
PLK,2,2016,2318,1044,1274,217,120,86,83
KVK,2,2016,3561,1636,1925,400,387,181,108
KVK,2,2016,5939,2750,3189,560,314,288,204
KVK,2,2016,5597,2808,2789,448,165,57,218
ULK,2,2016,8161,3965,4196,677,382,223,329
ULK,2,2016,8462,4360,4102,770,275,210,319
ULK,2,2016,6093,3050,3043,539,485,284,276
ULK,2,2016,5184,2486,2698,487,272,146,219
ULK,2,2016,8877,4710,4167,759,306,260,396
ULK,2,2016,7159,3702,3457,830,471,395,276
ULK,2,2016,8431,4003,4428,610,258,302,336
LBK,2,2016,4226,2249,1977,478,324,256,191
LBK,2,2016,3755,1939,1816,372,153,144,205
LBK,2,2016,8345,4348,3997,836,531,631,370
LBK,2,2016,3260,1475,1785,301,113,122,158
HKK,2,2016,6334,2886,3448,566,864,615,407
HKK,2,2016,2163,1079,1084,251,233,127,113
HKK,2,2016,3949,1741,2208,394,357,333,191
HKK,2,2016,1559,873,686,213,287,226,69
HKK,2,2016,4529,2170,2359,432,474,415,210
PAK,2,2016,4362,1935,2427,397,306,199,232
PAK,2,2016,5120,2637,2483,659,921,366,278
PAK,2,2016,4938,2254,2684,362,281,170,239
PAK,2,2016,4545,2110,2435,494,494,297,231
VYS,2,2016,3702,1897,1805,333,147,72,188
VYS,2,2016,4507,2007,2500,469,577,345,229
VYS,2,2016,2042,965,1077,222,199,140,86
VYS,2,2016,6459,3160,3299,466,187,102,326
VYS,2,2016,5168,2384,2784,459,305,288,292
JHM,2,2016,4204,2160,2044,401,216,250,230
JHM,2,2016,19530,10105,9425,1712,1835,2307,739
JHM,2,2016,7482,3781,3701,773,509,270,420
JHM,2,2016,5254,2478,2776,493,428,327,293
JHM,2,2016,9904,4387,5517,742,522,428,455
JHM,2,2016,3090,1458,1632,326,153,181,183
JHM,2,2016,7660,3572,4088,671,287,250,356
OLK,2,2016,2825,1251,1574,234,96,126,93
OLK,2,2016,11566,5307,6259,1082,1027,722,538
OLK,2,2016,4167,2196,1971,399,545,331,170
OLK,2,2016,7485,3583,3902,537,540,346,372
OLK,2,2016,5817,2583,3234,456,270,298,242
ZLK,2,2016,5452,2530,2922,449,258,238,294
ZLK,2,2016,5275,2600,2675,553,262,231,301
ZLK,2,2016,6951,3103,3848,578,545,321,347
ZLK,2,2016,6682,3252,3430,657,757,519,365
MSK,2,2016,7561,3539,4022,448,331,219,311
MSK,2,2016,8163,3922,4241,892,721,567,395
MSK,2,2016,19543,9402,10141,1312,333,360,719
MSK,2,2016,5634,2620,3014,568,850,841,276
MSK,2,2016,8825,3914,4911,691,541,549,459
MSK,2,2016,22847,11046,11801,1630,1053,912,934
PHA,3,2016,36538,18931,17607,3660,2191,1847,1381
STC,3,2016,2334,1205,1129,336,185,153,123
STC,3,2016,2907,1470,1437,297,197,238,143
STC,3,2016,7408,3743,3665,657,339,204,317
STC,3,2016,4642,2447,2195,489,545,524,241
STC,3,2016,3160,1643,1517,274,185,171,100
STC,3,2016,4894,2642,2252,420,315,312,226
STC,3,2016,2786,1537,1249,299,555,359,111
STC,3,2016,4069,2120,1949,394,259,541,183
STC,3,2016,2986,1623,1363,459,323,336,163
STC,3,2016,3297,1747,1550,406,76,74,150
STC,3,2016,5799,2777,3022,454,243,63,252
STC,3,2016,2135,1149,986,198,96,173,102
JHC,3,2016,5670,2855,2815,790,753,491,317
JHC,3,2016,3213,1601,1612,281,192,185,119
JHC,3,2016,3031,1467,1564,315,178,133,128
JHC,3,2016,2216,1086,1130,324,147,181,119
JHC,3,2016,1622,679,943,185,150,173,87
JHC,3,2016,2738,1304,1434,262,157,288,101
JHC,3,2016,4296,2137,2159,372,280,251,221
PLK,3,2016,2083,1109,974,205,374,203,89
PLK,3,2016,2758,1309,1449,315,161,199,109
PLK,3,2016,5653,3089,2564,744,717,532,279
PLK,3,2016,1772,938,834,204,163,243,92
PLK,3,2016,2162,1143,1019,249,187,306,88
PLK,3,2016,1158,645,513,161,98,129,55
PLK,3,2016,2144,999,1145,180,176,112,76
KVK,3,2016,3352,1560,1792,370,461,295,105
KVK,3,2016,5713,2670,3043,467,471,686,194
KVK,3,2016,5465,2748,2717,463,216,263,226
ULK,3,2016,7844,3838,4006,631,550,332,305
ULK,3,2016,8393,4329,4064,778,331,153,324
ULK,3,2016,5881,2982,2899,513,249,270,269
ULK,3,2016,5052,2485,2567,532,349,390,197
ULK,3,2016,8799,4639,4160,655,361,174,392
ULK,3,2016,7021,3628,3393,740,303,351,270
ULK,3,2016,8247,3923,4324,625,240,244,319
LBK,3,2016,3993,2143,1850,487,355,257,181
LBK,3,2016,3698,1896,1802,381,200,163,214
LBK,3,2016,8183,4277,3906,912,662,605,365
LBK,3,2016,3115,1436,1679,281,183,231,168
HKK,3,2016,6056,2839,3217,576,792,537,403
HKK,3,2016,2043,1034,1009,268,196,217,117
HKK,3,2016,3706,1664,2042,398,288,267,173
HKK,3,2016,1403,802,601,234,204,199,66
HKK,3,2016,4286,2092,2194,449,459,467,206
PAK,3,2016,3930,1792,2138,394,286,443,219
PAK,3,2016,4949,2563,2386,634,944,622,284
PAK,3,2016,4683,2191,2492,413,351,250,219
PAK,3,2016,4306,2033,2273,518,522,589,208
VYS,3,2016,3450,1823,1627,290,163,181,181
VYS,3,2016,4188,1917,2271,432,495,448,212
VYS,3,2016,1892,942,950,206,152,75,83
VYS,3,2016,6022,3090,2932,448,276,187,313
VYS,3,2016,4884,2296,2588,402,298,389,266
JHM,3,2016,4014,2077,1937,342,223,228,232
JHM,3,2016,19390,10050,9340,1603,1969,1996,753
JHM,3,2016,7230,3688,3542,774,615,471,419
JHM,3,2016,4858,2353,2505,456,522,357,299
JHM,3,2016,9362,4244,5118,697,648,470,446
JHM,3,2016,2932,1405,1527,315,178,154,169
JHM,3,2016,7191,3416,3775,585,226,147,334
OLK,3,2016,2630,1179,1451,220,77,94,86
OLK,3,2016,10880,5057,5823,942,1131,1088,486
OLK,3,2016,3961,2124,1837,434,391,539,170
OLK,3,2016,7021,3430,3591,509,480,376,342
OLK,3,2016,5635,2552,3083,547,304,346,237
ZLK,3,2016,5181,2421,2760,408,229,225,274
ZLK,3,2016,4998,2515,2483,503,310,278,292
ZLK,3,2016,6715,3032,3683,546,555,380,356
ZLK,3,2016,6285,3124,3161,574,527,399,335
MSK,3,2016,7249,3429,3820,467,215,303,286
MSK,3,2016,7876,3819,4057,861,818,937,384
MSK,3,2016,19342,9302,10040,1308,390,302,678
MSK,3,2016,5442,2545,2897,570,1205,1345,278
MSK,3,2016,8388,3783,4605,673,462,435,454
MSK,3,2016,22504,10931,11573,1599,851,840,960
PHA,4,2016,35728,18552,17176,3942,2042,1014,1334
STC,4,2016,2053,1104,949,314,209,99,107
STC,4,2016,2735,1416,1319,272,253,307,138
STC,4,2016,7195,3719,3476,639,283,336,315
STC,4,2016,4358,2368,1990,504,368,248,215
STC,4,2016,2836,1531,1305,275,283,157,89
STC,4,2016,4614,2511,2103,411,461,180,212
STC,4,2016,2678,1491,1187,326,372,541,100
STC,4,2016,3836,2067,1769,361,716,605,167
STC,4,2016,2791,1501,1290,414,255,904,146
STC,4,2016,3204,1679,1525,375,87,70,137
STC,4,2016,5292,2626,2666,461,261,123,238
STC,4,2016,1936,1061,875,195,89,28,91
JHC,4,2016,5291,2763,2528,799,618,561,280
JHC,4,2016,2907,1504,1403,289,273,204,113
JHC,4,2016,2343,1248,1095,356,278,157,104
JHC,4,2016,1891,991,900,293,310,192,111
JHC,4,2016,1351,634,717,201,132,99,66
JHC,4,2016,2404,1224,1180,289,225,117,92
JHC,4,2016,3899,2057,1842,390,289,237,206
PLK,4,2016,1869,1051,818,190,428,201,88
PLK,4,2016,2386,1254,1132,325,280,163,99
PLK,4,2016,5370,2960,2410,704,1021,643,271
PLK,4,2016,1605,884,721,170,129,88,80
PLK,4,2016,1962,1088,874,272,83,179,93
PLK,4,2016,1134,644,490,177,92,97,44
PLK,4,2016,1967,966,1001,241,443,308,78
KVK,4,2016,2976,1404,1572,348,396,263,98
KVK,4,2016,5414,2559,2855,459,440,388,196
KVK,4,2016,5267,2688,2579,400,210,144,213
ULK,4,2016,7570,3730,3840,789,415,665,303
ULK,4,2016,8276,4256,4020,757,310,374,332
ULK,4,2016,5508,2852,2656,536,542,410,241
ULK,4,2016,4882,2433,2449,583,235,284,186
ULK,4,2016,8769,4631,4138,731,327,176,368
ULK,4,2016,6794,3596,3198,635,282,238,247
ULK,4,2016,8180,3873,4307,815,259,240,303
LBK,4,2016,3728,2057,1671,499,311,320,170
LBK,4,2016,3577,1856,1721,447,144,183,221
LBK,4,2016,7909,4201,3708,833,743,645,344
LBK,4,2016,2896,1419,1477,366,234,181,155
HKK,4,2016,5558,2714,2844,610,842,816,377
HKK,4,2016,1780,973,807,278,232,86,102
HKK,4,2016,3327,1547,1780,488,334,244,159
HKK,4,2016,1227,719,508,253,227,281,73
HKK,4,2016,3984,2012,1972,549,394,387,192
PAK,4,2016,3255,1612,1643,401,327,219,180
PAK,4,2016,4522,2434,2088,639,1236,777,269
PAK,4,2016,3957,1986,1971,431,456,369,189
PAK,4,2016,3939,1981,1958,508,703,310,188
VYS,4,2016,3121,1750,1371,298,180,91,160
VYS,4,2016,3682,1819,1863,469,559,461,190
VYS,4,2016,1592,860,732,185,213,143,77
VYS,4,2016,5214,2804,2410,440,301,267,269
VYS,4,2016,4363,2180,2183,415,367,204,255
JHM,4,2016,3811,2008,1803,395,286,182,227
JHM,4,2016,19151,9973,9178,1732,2498,1791,711
JHM,4,2016,6890,3588,3302,789,634,506,409
JHM,4,2016,4242,2175,2067,557,390,345,265
JHM,4,2016,8675,4127,4548,738,573,621,392
JHM,4,2016,2636,1346,1290,342,211,111,144
JHM,4,2016,6371,3156,3215,666,289,264,314
OLK,4,2016,2185,1040,1145,297,102,99,82
OLK,4,2016,10010,4813,5197,1077,1285,1200,454
OLK,4,2016,3563,1957,1606,430,304,326,133
OLK,4,2016,6491,3297,3194,602,434,540,310
OLK,4,2016,5215,2470,2745,664,374,211,218
ZLK,4,2016,4734,2334,2400,442,302,307,251
ZLK,4,2016,4540,2414,2126,480,359,208,263
ZLK,4,2016,6151,2893,3258,571,393,408,338
ZLK,4,2016,5817,2995,2822,670,731,587,324
MSK,4,2016,6479,3216,3263,575,263,149,256
MSK,4,2016,7387,3638,3749,938,794,493,354
MSK,4,2016,19140,9275,9865,1424,454,322,644
MSK,4,2016,4953,2412,2541,596,489,489,240
MSK,4,2016,7576,3611,3965,646,583,497,430
MSK,4,2016,22041,10876,11165,1630,909,531,950
PHA,5,2016,34717,18065,16652,3683,2639,4117,1110
STC,5,2016,1857,1012,845,313,292,134,88
STC,5,2016,2631,1404,1227,301,223,93,111
STC,5,2016,7048,3667,3381,652,426,393,264
STC,5,2016,4176,2313,1863,527,705,438,184
STC,5,2016,2733,1549,1184,414,232,174,89
STC,5,2016,4410,2459,1951,414,523,269,201
STC,5,2016,2535,1426,1109,299,423,509,87
STC,5,2016,3760,2029,1731,404,326,204,154
STC,5,2016,2597,1439,1158,365,497,102,114
STC,5,2016,3052,1612,1440,337,120,38,111
STC,5,2016,4903,2472,2431,477,284,195,193
STC,5,2016,1862,1042,820,200,152,42,76
JHC,5,2016,4942,2630,2312,703,820,722,241
JHC,5,2016,2600,1377,1223,255,395,217,87
JHC,5,2016,2050,1146,904,329,187,133,80
JHC,5,2016,1692,935,757,281,229,184,97
JHC,5,2016,1233,600,633,201,92,54,51
JHC,5,2016,2226,1161,1065,265,255,183,79
JHC,5,2016,3628,2001,1627,407,345,177,186
PLK,5,2016,1708,995,713,184,353,348,76
PLK,5,2016,2208,1182,1026,312,373,143,86
PLK,5,2016,5157,2863,2294,736,1484,799,234
PLK,5,2016,1497,846,651,160,212,52,63
PLK,5,2016,1837,1038,799,270,173,116,82
PLK,5,2016,1109,638,471,156,86,78,32
PLK,5,2016,1868,940,928,190,235,199,74
KVK,5,2016,2734,1310,1424,365,337,382,96
KVK,5,2016,5142,2445,2697,437,456,398,165
KVK,5,2016,5147,2620,2527,473,184,204,189
ULK,5,2016,7239,3619,3620,692,372,337,260
ULK,5,2016,8090,4182,3908,691,367,239,300
ULK,5,2016,5144,2718,2426,498,385,421,209
ULK,5,2016,4765,2416,2349,495,319,217,168
ULK,5,2016,8641,4599,4042,648,389,295,334
ULK,5,2016,6543,3500,3043,620,362,398,219
ULK,5,2016,8098,3846,4252,716,316,241,287
LBK,5,2016,3481,1918,1563,441,515,506,148
LBK,5,2016,3403,1804,1599,372,149,120,196
LBK,5,2016,7557,4101,3456,744,687,742,311
LBK,5,2016,2647,1375,1272,282,135,133,130
HKK,5,2016,5313,2669,2644,536,833,849,309
HKK,5,2016,1571,879,692,247,151,148,96
HKK,5,2016,3096,1504,1592,394,366,326,137
HKK,5,2016,1078,648,430,164,531,213,63
HKK,5,2016,3679,1918,1761,434,627,608,157
PAK,5,2016,2904,1547,1357,369,320,331,152
PAK,5,2016,4225,2313,1912,588,943,715,236
PAK,5,2016,3479,1830,1649,374,254,259,156
PAK,5,2016,3637,1870,1767,466,719,590,156
VYS,5,2016,2940,1716,1224,271,167,137,129
VYS,5,2016,3419,1768,1651,415,393,422,157
VYS,5,2016,1477,833,644,228,173,83,56
VYS,5,2016,4751,2656,2095,397,307,164,227
VYS,5,2016,4076,2127,1949,410,327,235,199
JHM,5,2016,3569,1919,1650,359,233,210,175
JHM,5,2016,18760,9805,8955,1397,2368,2572,641
JHM,5,2016,6507,3439,3068,679,645,534,323
JHM,5,2016,3969,2075,1894,521,436,433,210
JHM,5,2016,8106,3960,4146,684,608,539,327
JHM,5,2016,2466,1316,1150,328,164,176,116
JHM,5,2016,5756,2924,2832,528,284,254,268
OLK,5,2016,1986,986,1000,293,103,97,66
OLK,5,2016,9423,4656,4767,986,1407,1161,409
OLK,5,2016,3413,1932,1481,428,299,290,106
OLK,5,2016,6200,3218,2982,526,588,557,270
OLK,5,2016,5012,2442,2570,663,367,323,175
ZLK,5,2016,4497,2278,2219,458,225,234,219
ZLK,5,2016,4216,2321,1895,488,411,316,209
ZLK,5,2016,5660,2767,2893,554,360,190,281
ZLK,5,2016,5501,2882,2619,623,630,281,261
MSK,5,2016,6071,3091,2980,589,300,235,210
MSK,5,2016,6956,3480,3476,865,857,905,306
MSK,5,2016,18866,9154,9712,1370,457,346,563
MSK,5,2016,4672,2319,2353,681,726,731,196
MSK,5,2016,7087,3511,3576,697,563,572,327
MSK,5,2016,21784,10779,11005,1618,864,504,860
PHA,6,2016,33963,17887,16076,3722,2872,1284,1058
STC,6,2016,1803,998,805,337,182,119,68
STC,6,2016,2602,1419,1183,314,283,139,105
STC,6,2016,6947,3632,3315,681,349,179,248
STC,6,2016,3997,2259,1738,464,379,482,168
STC,6,2016,2706,1532,1174,373,198,78,88
STC,6,2016,4314,2443,1871,415,323,470,164
STC,6,2016,2523,1444,1079,350,406,412,88
STC,6,2016,3717,2017,1700,417,275,402,138
STC,6,2016,2494,1403,1091,415,401,446,108
STC,6,2016,3073,1655,1418,395,153,199,109
STC,6,2016,4667,2371,2296,427,230,148,182
STC,6,2016,1795,1001,794,176,96,149,72
JHC,6,2016,4729,2584,2145,644,672,586,203
JHC,6,2016,2403,1284,1119,253,225,193,81
JHC,6,2016,1863,1041,822,253,195,174,74
JHC,6,2016,1698,959,739,338,245,167,91
JHC,6,2016,1202,591,611,181,128,90,46
JHC,6,2016,2169,1142,1027,296,249,274,66
JHC,6,2016,3559,2015,1544,405,278,192,160
PLK,6,2016,1648,975,673,194,265,314,75
PLK,6,2016,2122,1177,945,293,199,208,89
PLK,6,2016,5057,2791,2266,741,751,716,220
PLK,6,2016,1477,837,640,215,263,141,61
PLK,6,2016,1811,1021,790,240,85,87,69
PLK,6,2016,1096,621,475,154,759,169,28
PLK,6,2016,1820,943,877,211,224,114,65
KVK,6,2016,2533,1244,1289,357,287,163,88
KVK,6,2016,4948,2393,2555,468,391,383,146
KVK,6,2016,4995,2579,2416,407,319,301,163
ULK,6,2016,7027,3546,3481,640,348,248,232
ULK,6,2016,7957,4169,3788,750,256,347,283
ULK,6,2016,5017,2692,2325,527,397,475,189
ULK,6,2016,4654,2378,2276,486,310,210,149
ULK,6,2016,8418,4496,3922,578,345,218,294
ULK,6,2016,6440,3453,2987,648,244,278,213
ULK,6,2016,7899,3816,4083,527,236,210,268
LBK,6,2016,3254,1819,1435,451,303,495,120
LBK,6,2016,3365,1816,1549,366,214,148,174
LBK,6,2016,7343,4034,3309,750,671,630,284
LBK,6,2016,2526,1363,1163,273,122,169,113
HKK,6,2016,5171,2644,2527,566,904,621,290
HKK,6,2016,1520,837,683,260,187,146,95
HKK,6,2016,3043,1498,1545,396,377,298,143
HKK,6,2016,1061,641,420,185,168,127,63
HKK,6,2016,3494,1855,1639,396,814,488,144
PAK,6,2016,2710,1492,1218,378,367,377,133
PAK,6,2016,4096,2291,1805,581,1394,615,205
PAK,6,2016,3250,1757,1493,350,258,415,137
PAK,6,2016,3434,1804,1630,432,468,399,141
VYS,6,2016,2870,1706,1164,296,131,210,114
VYS,6,2016,3333,1757,1576,423,589,457,139
VYS,6,2016,1421,803,618,209,150,96,57
VYS,6,2016,4629,2618,2011,413,225,323,212
VYS,6,2016,3996,2123,1873,450,204,118,184
JHM,6,2016,3497,1927,1570,403,214,171,164
JHM,6,2016,18524,9787,8737,1522,2084,2018,608
JHM,6,2016,6261,3404,2857,724,572,419,275
JHM,6,2016,3805,2006,1799,463,552,398,196
JHM,6,2016,7864,3891,3973,768,574,459,304
JHM,6,2016,2403,1307,1096,312,235,113,116
JHM,6,2016,5412,2755,2657,496,200,192,237
OLK,6,2016,1881,938,943,238,82,78,60
OLK,6,2016,9236,4622,4614,1062,910,1049,381
OLK,6,2016,3371,1947,1424,402,313,248,106
OLK,6,2016,6046,3170,2876,525,575,570,241
OLK,6,2016,4867,2441,2426,535,305,268,167
ZLK,6,2016,4394,2271,2123,450,298,253,201
ZLK,6,2016,4091,2302,1789,528,399,369,203
ZLK,6,2016,5405,2690,2715,615,440,476,240
ZLK,6,2016,5253,2815,2438,644,513,270,239
MSK,6,2016,5899,3054,2845,517,312,268,168
MSK,6,2016,6795,3422,3373,900,772,863,270
MSK,6,2016,18710,9076,9634,1385,563,496,506
MSK,6,2016,4561,2312,2249,599,988,1116,175
MSK,6,2016,6791,3426,3365,635,337,311,279
MSK,6,2016,21603,10716,10887,1628,1153,1568,785
PHA,7,2016,34835,18728,16107,4407,2208,1234,1085
STC,7,2016,1828,1053,775,379,150,108,81
STC,7,2016,2662,1485,1177,331,135,122,116
STC,7,2016,7039,3743,3296,674,350,130,242
STC,7,2016,4029,2339,1690,544,175,220,166
STC,7,2016,2758,1587,1171,385,148,104,89
STC,7,2016,4349,2519,1830,457,531,678,157
STC,7,2016,2611,1517,1094,364,239,420,84
STC,7,2016,3758,2080,1678,405,186,267,170
STC,7,2016,2589,1501,1088,504,567,242,111
STC,7,2016,3134,1733,1401,425,125,13,117
STC,7,2016,4734,2479,2255,579,205,133,186
STC,7,2016,1804,1039,765,220,81,83,74
JHC,7,2016,4941,2758,2183,808,434,436,257
JHC,7,2016,2418,1317,1101,286,134,183,102
JHC,7,2016,1878,1081,797,365,114,174,80
JHC,7,2016,1741,1010,731,304,186,112,104
JHC,7,2016,1227,627,600,191,44,51,52
JHC,7,2016,2229,1217,1012,317,179,123,73
JHC,7,2016,3663,2105,1558,456,211,219,187
PLK,7,2016,1680,1015,665,210,123,73,74
PLK,7,2016,2199,1241,958,376,154,114,114
PLK,7,2016,5302,2988,2314,886,861,866,281
PLK,7,2016,1511,875,636,217,92,84,64
PLK,7,2016,1869,1080,789,294,38,27,74
PLK,7,2016,1134,665,469,183,57,70,40
PLK,7,2016,1849,969,880,209,145,43,60
KVK,7,2016,2551,1305,1246,434,311,338,86
KVK,7,2016,4911,2435,2476,457,318,269,149
KVK,7,2016,4982,2599,2383,424,128,300,148
ULK,7,2016,7114,3667,3447,751,191,194,220
ULK,7,2016,7923,4192,3731,739,251,302,282
ULK,7,2016,5090,2818,2272,636,213,240,192
ULK,7,2016,4594,2414,2180,452,196,238,173
ULK,7,2016,8401,4562,3839,645,235,185,267
ULK,7,2016,6394,3485,2909,599,237,134,218
ULK,7,2016,7881,3887,3994,623,183,191,281
LBK,7,2016,3320,1899,1421,505,307,241,132
LBK,7,2016,3472,1904,1568,445,150,67,173
LBK,7,2016,7450,4169,3281,888,671,667,270
LBK,7,2016,2593,1439,1154,367,83,82,123
HKK,7,2016,5321,2815,2506,672,675,776,304
HKK,7,2016,1604,914,690,310,174,125,115
HKK,7,2016,3173,1613,1560,492,262,274,154
HKK,7,2016,1137,700,437,262,110,117,72
HKK,7,2016,3535,1923,1612,486,466,610,158
PAK,7,2016,2902,1684,1218,579,259,209,152
PAK,7,2016,4342,2504,1838,781,986,759,220
PAK,7,2016,3504,1970,1534,628,156,125,169
PAK,7,2016,3672,2033,1639,655,276,255,164
VYS,7,2016,3007,1831,1176,417,94,57,125
VYS,7,2016,3543,1937,1606,601,340,305,165
VYS,7,2016,1508,877,631,270,130,80,77
VYS,7,2016,4756,2754,2002,549,200,117,247
VYS,7,2016,4144,2287,1857,568,210,227,225
JHM,7,2016,3574,2021,1553,452,146,130,195
JHM,7,2016,18921,10183,8738,1907,1784,1896,648
JHM,7,2016,6505,3637,2868,947,425,146,315
JHM,7,2016,3932,2120,1812,582,288,262,218
JHM,7,2016,8003,4098,3905,919,366,641,346
JHM,7,2016,2446,1354,1092,364,153,95,117
JHM,7,2016,5614,2971,2643,681,262,222,248
OLK,7,2016,1892,948,944,253,51,60,75
OLK,7,2016,9269,4771,4498,1050,587,598,402
OLK,7,2016,3427,1995,1432,412,143,125,115
OLK,7,2016,6142,3266,2876,620,298,479,273
OLK,7,2016,5025,2595,2430,681,213,202,190
ZLK,7,2016,4488,2375,2113,522,283,170,223
ZLK,7,2016,4188,2447,1741,640,171,142,231
ZLK,7,2016,5554,2879,2675,731,332,269,285
ZLK,7,2016,5477,2990,2487,861,447,863,264
MSK,7,2016,5873,3068,2805,514,238,177,176
MSK,7,2016,7084,3640,3444,1091,594,506,344
MSK,7,2016,18946,9275,9671,1480,341,321,544
MSK,7,2016,4801,2501,2300,786,324,283,223
MSK,7,2016,7009,3634,3375,901,359,383,344
MSK,7,2016,21902,11014,10888,1875,828,715,848
PHA,8,2016,34610,18703,15907,4078,2733,2087,1178
STC,8,2016,1837,1046,791,364,184,127,106
STC,8,2016,2653,1486,1167,320,159,144,125
STC,8,2016,6907,3724,3183,649,283,225,250
STC,8,2016,4031,2344,1687,526,282,479,195
STC,8,2016,2687,1554,1133,315,201,313,89
STC,8,2016,4228,2459,1769,394,413,404,151
STC,8,2016,2624,1532,1092,355,423,393,88
STC,8,2016,3743,2095,1648,429,535,353,176
STC,8,2016,2531,1484,1047,429,306,327,134
STC,8,2016,3095,1721,1374,408,205,52,128
STC,8,2016,4698,2473,2225,516,225,181,200
STC,8,2016,1800,1062,738,240,99,146,82
JHC,8,2016,4819,2736,2083,714,699,552,267
JHC,8,2016,2390,1312,1078,257,226,125,95
JHC,8,2016,1861,1092,769,311,189,149,103
JHC,8,2016,1645,954,691,242,224,250,100
JHC,8,2016,1228,635,593,211,152,56,65
JHC,8,2016,2209,1220,989,265,189,164,88
JHC,8,2016,3608,2071,1537,410,282,191,186
PLK,8,2016,1636,974,662,178,319,363,81
PLK,8,2016,2170,1235,935,330,272,227,130
PLK,8,2016,5187,2969,2218,667,1168,1167,297
PLK,8,2016,1513,878,635,200,120,116,75
PLK,8,2016,1889,1102,787,267,95,166,86
PLK,8,2016,1135,671,464,158,128,91,56
PLK,8,2016,1833,955,878,209,233,241,66
KVK,8,2016,2466,1253,1213,370,256,216,79
KVK,8,2016,4765,2362,2403,465,440,415,133
KVK,8,2016,4786,2510,2276,439,285,251,140
ULK,8,2016,6965,3632,3333,553,322,253,242
ULK,8,2016,7845,4183,3662,756,292,276,292
ULK,8,2016,5037,2780,2257,575,521,327,208
ULK,8,2016,4523,2402,2121,461,241,232,177
ULK,8,2016,8261,4513,3748,616,384,191,295
ULK,8,2016,6404,3473,2931,639,279,265,228
ULK,8,2016,7784,3855,3929,570,268,280,288
LBK,8,2016,3260,1855,1405,433,368,370,146
LBK,8,2016,3466,1924,1542,384,194,117,160
LBK,8,2016,7347,4165,3182,797,773,597,279
LBK,8,2016,2589,1455,1134,299,138,99,148
HKK,8,2016,5274,2802,2472,578,851,874,327
HKK,8,2016,1607,930,677,280,188,187,119
HKK,8,2016,3143,1621,1522,444,493,278,181
HKK,8,2016,1118,689,429,206,318,215,79
HKK,8,2016,3430,1894,1536,423,347,435,152
PAK,8,2016,2810,1639,1171,404,255,313,179
PAK,8,2016,4248,2465,1783,631,1111,757,229
PAK,8,2016,3514,1963,1551,459,214,241,180
PAK,8,2016,3590,2004,1586,533,551,365,184
VYS,8,2016,3027,1844,1183,309,268,243,151
VYS,8,2016,3538,1948,1590,442,698,387,186
VYS,8,2016,1502,884,618,227,282,153,91
VYS,8,2016,4717,2736,1981,481,291,209,279
VYS,8,2016,4149,2290,1859,459,256,236,264
JHM,8,2016,3523,2013,1510,369,158,220,215
JHM,8,2016,18815,10163,8652,1562,2058,2172,679
JHM,8,2016,6451,3617,2834,735,611,547,349
JHM,8,2016,3877,2095,1782,473,693,449,245
JHM,8,2016,7993,4092,3901,800,465,421,413
JHM,8,2016,2400,1328,1072,351,198,152,129
JHM,8,2016,5602,3011,2591,576,237,292,254
OLK,8,2016,1810,935,875,195,79,112,77
OLK,8,2016,9068,4714,4354,1038,882,827,423
OLK,8,2016,3457,2034,1423,403,266,207,131
OLK,8,2016,6081,3263,2818,579,448,1053,300
OLK,8,2016,4989,2611,2378,569,264,216,213
ZLK,8,2016,4428,2337,2091,456,273,343,241
ZLK,8,2016,4126,2399,1727,545,280,177,277
ZLK,8,2016,5527,2903,2624,620,510,439,300
ZLK,8,2016,5439,2999,2440,721,711,858,308
MSK,8,2016,5835,3087,2748,512,260,192,204
MSK,8,2016,7063,3658,3405,947,677,810,390
MSK,8,2016,18778,9158,9620,1351,399,468,590
MSK,8,2016,4804,2519,2285,676,782,567,252
MSK,8,2016,6941,3609,3332,694,418,252,385
MSK,8,2016,21735,11002,10733,1627,903,645,886
PHA,9,2016,33069,17615,15454,4294,2668,1920,1243
STC,9,2016,1819,1010,809,481,224,265,151
STC,9,2016,2546,1394,1152,381,233,200,142
STC,9,2016,6762,3625,3137,812,281,422,316
STC,9,2016,4013,2297,1716,678,365,240,230
STC,9,2016,2608,1446,1162,428,219,68,120
STC,9,2016,4147,2360,1787,633,452,413,222
STC,9,2016,2540,1436,1104,390,462,315,117
STC,9,2016,3602,1956,1646,529,414,258,197
STC,9,2016,2387,1374,1013,513,624,240,141
STC,9,2016,3015,1653,1362,455,255,216,180
STC,9,2016,4619,2372,2247,648,164,347,259
STC,9,2016,1753,1023,730,304,61,73,101
JHC,9,2016,4654,2611,2043,931,975,509,300
JHC,9,2016,2357,1289,1068,344,352,231,122
JHC,9,2016,1788,1019,769,400,194,166,123
JHC,9,2016,1634,938,696,392,370,335,136
JHC,9,2016,1190,593,597,243,192,386,95
JHC,9,2016,2101,1122,979,367,200,301,127
JHC,9,2016,3541,2006,1535,543,288,260,229
PLK,9,2016,1582,910,672,239,275,305,89
PLK,9,2016,2053,1165,888,403,223,340,156
PLK,9,2016,4874,2757,2117,877,924,959,311
PLK,9,2016,1476,835,641,241,95,65,108
PLK,9,2016,1851,1068,783,359,95,77,129
PLK,9,2016,1107,652,455,200,250,198,71
PLK,9,2016,1780,898,882,286,105,142,96
KVK,9,2016,2361,1204,1157,451,342,274,114
KVK,9,2016,4706,2304,2402,632,366,294,167
KVK,9,2016,4716,2435,2281,589,204,106,212
ULK,9,2016,6896,3546,3350,910,268,430,320
ULK,9,2016,7776,4148,3628,904,382,303,355
ULK,9,2016,4929,2688,2241,738,326,307,291
ULK,9,2016,4474,2379,2095,610,183,136,217
ULK,9,2016,8102,4384,3718,830,223,406,379
ULK,9,2016,6299,3390,2909,729,231,227,302
ULK,9,2016,7610,3760,3850,714,249,250,340
LBK,9,2016,3247,1817,1430,652,317,433,207
LBK,9,2016,3383,1877,1506,573,201,201,201
LBK,9,2016,7093,3964,3129,1013,620,655,351
LBK,9,2016,2502,1378,1124,393,148,208,160
HKK,9,2016,5043,2647,2396,736,881,755,349
HKK,9,2016,1513,861,652,321,145,193,146
HKK,9,2016,3037,1531,1506,528,402,328,190
HKK,9,2016,1068,632,436,301,301,294,96
HKK,9,2016,3418,1865,1553,579,422,294,221
PAK,9,2016,2637,1473,1164,576,242,361,228
PAK,9,2016,4068,2286,1782,806,1112,1143,275
PAK,9,2016,3348,1773,1575,562,356,529,235
PAK,9,2016,3381,1880,1501,621,551,360,216
VYS,9,2016,2882,1722,1160,424,222,201,166
VYS,9,2016,3423,1857,1566,654,645,557,214
VYS,9,2016,1408,795,613,301,166,195,112
VYS,9,2016,4604,2597,2007,669,170,173,355
VYS,9,2016,4041,2175,1866,592,243,158,312
JHM,9,2016,3445,1905,1540,517,182,210,261
JHM,9,2016,18294,9769,8525,1978,2004,1949,748
JHM,9,2016,6255,3425,2830,987,508,370,438
JHM,9,2016,3737,1998,1739,687,375,509,292
JHM,9,2016,7782,3893,3889,994,480,397,479
JHM,9,2016,2318,1250,1068,390,101,90,176
JHM,9,2016,5418,2887,2531,734,206,277,330
OLK,9,2016,1794,918,876,275,68,63,110
OLK,9,2016,8902,4581,4321,1311,724,820,519
OLK,9,2016,3472,2004,1468,544,271,336,197
OLK,9,2016,5979,3157,2822,731,412,363,359
OLK,9,2016,4827,2492,2335,699,238,270,267
ZLK,9,2016,4298,2253,2045,589,281,279,281
ZLK,9,2016,4001,2269,1732,696,244,205,317
ZLK,9,2016,5371,2718,2653,846,394,348,404
ZLK,9,2016,5235,2823,2412,876,499,868,369
MSK,9,2016,5812,3069,2743,732,203,217,293
MSK,9,2016,7039,3618,3421,1236,619,565,491
MSK,9,2016,18636,8955,9681,1824,408,384,742
MSK,9,2016,4744,2497,2247,841,1293,1296,297
MSK,9,2016,6797,3488,3309,986,329,491,478
MSK,9,2016,21269,10605,10664,2074,914,577,964
PHA,10,2016,32024,16977,15047,4050,2501,1962,1283
STC,10,2016,1711,964,747,315,147,161,130
STC,10,2016,2487,1335,1152,309,224,226,140
STC,10,2016,6459,3457,3002,615,377,219,301
STC,10,2016,3813,2165,1648,476,302,502,211
STC,10,2016,2463,1356,1107,333,158,141,113
STC,10,2016,4062,2290,1772,521,313,582,245
STC,10,2016,2443,1373,1070,337,307,535,111
STC,10,2016,3426,1858,1568,406,334,264,186
STC,10,2016,2319,1316,1003,404,473,303,153
STC,10,2016,2768,1516,1252,378,104,46,160
STC,10,2016,4458,2245,2213,540,191,536,239
STC,10,2016,1653,992,661,189,68,79,87
JHC,10,2016,4477,2466,2011,735,556,786,278
JHC,10,2016,2355,1312,1043,344,181,206,118
JHC,10,2016,1795,1033,762,388,223,234,116
JHC,10,2016,1639,923,716,347,283,263,112
JHC,10,2016,1156,595,561,212,129,75,90
JHC,10,2016,2057,1102,955,331,143,120,124
JHC,10,2016,3394,1894,1500,413,263,257,212
PLK,10,2016,1530,892,638,206,178,241,90
PLK,10,2016,1913,1069,844,338,380,250,121
PLK,10,2016,4609,2593,2016,745,1273,1304,320
PLK,10,2016,1377,786,591,172,152,123,92
PLK,10,2016,1760,990,770,240,83,81,114
PLK,10,2016,1057,619,438,149,151,168,58
PLK,10,2016,1725,866,859,219,146,127,91
KVK,10,2016,2282,1156,1126,361,166,343,116
KVK,10,2016,4589,2264,2325,496,463,334,162
KVK,10,2016,4548,2354,2194,476,120,109,218
ULK,10,2016,6724,3398,3326,722,271,297,311
ULK,10,2016,7521,3997,3524,731,291,267,314
ULK,10,2016,4819,2618,2201,551,358,534,276
ULK,10,2016,4366,2324,2042,520,457,330,227
ULK,10,2016,7959,4309,3650,718,224,170,382
ULK,10,2016,6068,3252,2816,572,254,250,316
ULK,10,2016,7285,3612,3673,614,242,200,337
LBK,10,2016,3180,1774,1406,516,221,212,189
LBK,10,2016,3235,1795,1440,366,102,130,204
LBK,10,2016,6802,3792,3010,854,417,574,354
LBK,10,2016,2421,1335,1086,320,209,146,152
HKK,10,2016,4866,2516,2350,648,812,1045,340
HKK,10,2016,1437,785,652,259,127,164,143
HKK,10,2016,2986,1481,1505,487,288,409,184
HKK,10,2016,991,587,404,233,223,256,75
HKK,10,2016,3326,1776,1550,481,368,503,216
PAK,10,2016,2547,1370,1177,412,230,215,217
PAK,10,2016,3884,2174,1710,633,829,1041,264
PAK,10,2016,3250,1718,1532,408,257,287,219
PAK,10,2016,3148,1707,1441,487,442,368,204
VYS,10,2016,2711,1606,1105,315,279,227,152
VYS,10,2016,3274,1757,1517,410,383,422,205
VYS,10,2016,1340,744,596,224,191,204,92
VYS,10,2016,4480,2511,1969,526,404,567,298
VYS,10,2016,3952,2123,1829,453,222,513,286
JHM,10,2016,3337,1824,1513,389,142,187,225
JHM,10,2016,17819,9481,8338,1492,1868,1864,705
JHM,10,2016,6047,3281,2766,728,453,244,393
JHM,10,2016,3584,1913,1671,477,397,781,264
JHM,10,2016,7556,3799,3757,719,321,379,440
JHM,10,2016,2238,1203,1035,319,322,161,168
JHM,10,2016,5343,2871,2472,636,220,126,305
OLK,10,2016,1843,926,917,310,66,129,106
OLK,10,2016,8704,4459,4245,1086,710,970,503
OLK,10,2016,3350,1914,1436,402,408,347,166
OLK,10,2016,5811,3101,2710,563,375,341,323
OLK,10,2016,4625,2400,2225,526,442,288,238
ZLK,10,2016,4202,2189,2013,484,238,238,265
ZLK,10,2016,3897,2184,1713,525,191,353,278
ZLK,10,2016,5278,2614,2664,699,481,630,369
ZLK,10,2016,5056,2712,2344,704,651,644,319
MSK,10,2016,5693,3007,2686,516,216,160,278
MSK,10,2016,6784,3434,3350,885,644,670,437
MSK,10,2016,18342,8828,9514,1402,381,364,713
MSK,10,2016,4474,2353,2121,590,461,585,262
MSK,10,2016,6537,3305,3232,675,417,474,416
MSK,10,2016,20803,10337,10466,1643,874,855,924
PHA,11,2016,30663,16224,14439,3563,2529,2326,1159
STC,11,2016,1741,956,785,404,152,160,101
STC,11,2016,2420,1289,1131,310,260,244,120
STC,11,2016,6358,3371,2987,726,213,410,282
STC,11,2016,3681,2067,1614,524,535,328,188
STC,11,2016,2522,1378,1144,411,165,102,105
STC,11,2016,3992,2239,1753,456,440,424,211
STC,11,2016,2370,1313,1057,328,714,408,97
STC,11,2016,3382,1809,1573,458,713,551,185
STC,11,2016,2226,1257,969,413,389,309,120
STC,11,2016,2687,1459,1228,366,164,61,161
STC,11,2016,4476,2199,2277,669,144,101,213
STC,11,2016,1656,990,666,244,78,161,81
JHC,11,2016,4422,2384,2038,785,713,878,249
JHC,11,2016,2466,1361,1105,437,139,109,110
JHC,11,2016,1896,1059,837,466,239,206,93
JHC,11,2016,1720,955,765,433,159,334,91
JHC,11,2016,1216,598,618,294,100,161,84
JHC,11,2016,2082,1080,1002,345,165,236,107
JHC,11,2016,3423,1866,1557,464,274,246,197
PLK,11,2016,1506,864,642,240,119,424,79
PLK,11,2016,2019,1116,903,472,191,348,98
PLK,11,2016,4309,2413,1896,654,804,984,289
PLK,11,2016,1358,790,568,212,92,200,84
PLK,11,2016,1799,997,802,320,82,53,109
PLK,11,2016,1041,611,430,162,124,829,50
PLK,11,2016,1611,823,788,183,106,138,67
KVK,11,2016,2244,1132,1112,491,177,328,102
KVK,11,2016,4502,2216,2286,531,330,518,159
KVK,11,2016,4521,2328,2193,561,127,163,211
ULK,11,2016,6781,3417,3364,768,268,204,304
ULK,11,2016,7198,3819,3379,671,367,214,274
ULK,11,2016,4822,2572,2250,724,302,309,249
ULK,11,2016,4283,2291,1992,507,326,496,202
ULK,11,2016,7723,4190,3533,695,319,233,345
ULK,11,2016,5889,3170,2719,637,271,341,281
ULK,11,2016,7021,3428,3593,478,315,241,315
LBK,11,2016,3251,1788,1463,583,233,295,180
LBK,11,2016,3144,1722,1422,333,151,181,192
LBK,11,2016,6738,3705,3033,841,576,687,337
LBK,11,2016,2485,1331,1154,415,185,132,144
HKK,11,2016,4786,2417,2369,673,701,647,320
HKK,11,2016,1462,771,691,326,141,213,120
HKK,11,2016,3011,1482,1529,513,245,209,161
HKK,11,2016,978,583,395,231,225,222,55
HKK,11,2016,3279,1733,1546,515,428,389,178
PAK,11,2016,2663,1369,1294,590,258,246,189
PAK,11,2016,3874,2122,1752,708,940,911,246
PAK,11,2016,3374,1725,1649,634,259,149,187
PAK,11,2016,3088,1626,1462,535,409,495,173
VYS,11,2016,2580,1527,1053,305,207,311,128
VYS,11,2016,3179,1667,1512,500,302,274,181
VYS,11,2016,1308,714,594,247,125,164,83
VYS,11,2016,4560,2516,2044,636,214,291,272
VYS,11,2016,3961,2077,1884,546,232,288,268
JHM,11,2016,3249,1732,1517,388,157,207,193
JHM,11,2016,17507,9222,8285,1468,1852,1905,635
JHM,11,2016,5981,3190,2791,783,488,323,347
JHM,11,2016,3837,1963,1874,789,304,626,253
JHM,11,2016,7625,3760,3865,882,376,367,396
JHM,11,2016,2219,1163,1056,350,132,201,150
JHM,11,2016,5737,3082,2655,981,170,219,280
OLK,11,2016,2075,1036,1039,467,76,55,85
OLK,11,2016,8684,4391,4293,1209,600,714,453
OLK,11,2016,3275,1825,1450,430,293,320,139
OLK,11,2016,5794,3044,2750,627,420,448,298
OLK,11,2016,4696,2375,2321,671,281,339,202
ZLK,11,2016,4132,2133,1999,466,211,277,240
ZLK,11,2016,3989,2130,1859,618,208,330,254
ZLK,11,2016,5319,2559,2760,795,364,474,309
ZLK,11,2016,4982,2623,2359,752,520,912,266
MSK,11,2016,5735,3016,2719,657,121,235,248
MSK,11,2016,6726,3315,3411,1008,540,667,378
MSK,11,2016,18156,8683,9473,1441,403,483,652
MSK,11,2016,4434,2264,2170,714,649,753,213
MSK,11,2016,6490,3216,3274,760,314,401,378
MSK,11,2016,20366,10103,10263,1642,665,1205,857
PHA,12,2016,30179,15882,14297,3053,2377,2648,1096
STC,12,2016,1829,946,883,374,98,104,96
STC,12,2016,2471,1291,1180,318,129,71,107
STC,12,2016,6502,3412,3090,683,140,126,272
STC,12,2016,3970,2148,1822,738,243,185,170
STC,12,2016,2674,1399,1275,426,78,101,95
STC,12,2016,4067,2265,1802,531,418,246,183
STC,12,2016,2382,1317,1065,308,185,206,90
STC,12,2016,3559,1869,1690,498,176,306,188
STC,12,2016,2244,1269,975,381,367,132,111
STC,12,2016,2710,1467,1243,325,73,22,135
STC,12,2016,4783,2260,2523,835,163,343,211
STC,12,2016,1775,1009,766,293,125,79,71
JHC,12,2016,4688,2424,2264,856,413,358,243
JHC,12,2016,2774,1416,1358,544,153,288,102
JHC,12,2016,2435,1193,1242,790,238,320,93
JHC,12,2016,1896,986,910,488,114,150,80
JHC,12,2016,1482,642,840,432,59,105,80
JHC,12,2016,2352,1139,1213,491,160,78,93
JHC,12,2016,3758,1921,1837,644,178,166,193
PLK,12,2016,1647,841,806,340,184,220,68
PLK,12,2016,2364,1125,1239,611,128,183,103
PLK,12,2016,4341,2330,2011,718,559,435,241
PLK,12,2016,1458,810,648,250,41,97,80
PLK,12,2016,1913,1018,895,333,62,146,96
PLK,12,2016,1117,638,479,199,84,73,46
PLK,12,2016,1815,869,946,399,117,62,65
KVK,12,2016,2354,1165,1189,450,173,93,95
KVK,12,2016,4667,2237,2430,639,207,220,166
KVK,12,2016,4775,2451,2324,655,143,221,195
ULK,12,2016,6927,3455,3472,769,150,184,295
ULK,12,2016,7254,3878,3376,701,206,284,261
ULK,12,2016,5096,2665,2431,799,239,284,232
ULK,12,2016,4433,2278,2155,538,279,363,204
ULK,12,2016,7697,4183,3514,612,295,401,328
ULK,12,2016,6014,3217,2797,654,172,153,266
ULK,12,2016,7107,3442,3665,586,169,281,305
LBK,12,2016,3365,1805,1560,577,184,329,160
LBK,12,2016,3190,1709,1481,369,92,131,186
LBK,12,2016,6870,3673,3197,839,441,479,319
LBK,12,2016,2679,1341,1338,512,137,168,146
HKK,12,2016,4924,2408,2516,709,546,705,288
HKK,12,2016,1586,789,797,334,150,120,106
HKK,12,2016,3318,1510,1808,597,143,239,157
HKK,12,2016,984,575,409,228,98,104,47
HKK,12,2016,3458,1714,1744,594,258,313,170
PAK,12,2016,3145,1420,1725,820,187,252,186
PAK,12,2016,4081,2162,1919,723,778,813,225
PAK,12,2016,3839,1805,2034,828,247,356,192
PAK,12,2016,3342,1651,1691,592,901,1016,164
VYS,12,2016,2946,1585,1361,619,126,161,123
VYS,12,2016,3603,1714,1889,753,341,244,182
VYS,12,2016,1562,761,801,421,75,58,83
VYS,12,2016,5122,2588,2534,977,175,193,250
VYS,12,2016,4439,2149,2290,796,216,332,273
JHM,12,2016,3467,1791,1676,492,154,109,185
JHM,12,2016,17516,9191,8325,1297,1151,1553,617
JHM,12,2016,6300,3252,3048,877,670,395,328
JHM,12,2016,4420,2112,2308,953,313,259,245
JHM,12,2016,8524,3945,4579,1417,289,486,387
JHM,12,2016,2375,1198,1177,416,34,86,150
JHM,12,2016,6430,3201,3229,1125,63,212,276
OLK,12,2016,2376,1066,1310,502,35,22,82
OLK,12,2016,9319,4390,4929,1532,523,503,435
OLK,12,2016,3367,1822,1545,456,258,278,130
OLK,12,2016,6286,3089,3197,974,273,460,277
OLK,12,2016,5147,2426,2721,866,132,196,205
ZLK,12,2016,4433,2145,2288,677,180,180,223
ZLK,12,2016,4396,2214,2182,788,142,256,251
ZLK,12,2016,5698,2605,3093,911,257,377,298
ZLK,12,2016,5321,2657,2664,919,354,216,240
MSK,12,2016,6331,3061,3270,1004,117,144,251
MSK,12,2016,7090,3346,3744,1148,337,356,345
MSK,12,2016,18153,8640,9513,1209,250,373,608
MSK,12,2016,4793,2289,2504,840,766,1010,199
MSK,12,2016,7173,3246,3927,1234,425,380,372
MSK,12,2016,20496,10094,10402,1506,445,564,860
PHA,1,2017,30128,15714,14414,4667,3287,2410,997
STC,1,2017,1897,970,927,465,238,237,75
STC,1,2017,2485,1273,1212,425,195,321,91
STC,1,2017,6561,3383,3178,820,197,324,261
STC,1,2017,4077,2137,1940,755,453,623,160
STC,1,2017,2753,1396,1357,472,196,399,83
STC,1,2017,4060,2266,1794,535,483,552,165
STC,1,2017,2454,1341,1113,437,492,334,80
STC,1,2017,3598,1876,1722,560,432,179,182
STC,1,2017,2282,1274,1008,551,479,452,102
STC,1,2017,2726,1481,1245,488,174,241,121
STC,1,2017,4915,2205,2710,831,248,283,183
STC,1,2017,1862,1031,831,314,76,97,77
JHC,1,2017,4864,2364,2500,1117,538,637,211
JHC,1,2017,3051,1442,1609,621,373,171,118
JHC,1,2017,2817,1251,1566,738,228,133,90
JHC,1,2017,2055,983,1072,573,202,226,84
JHC,1,2017,1594,627,967,383,161,157,67
JHC,1,2017,2509,1144,1365,530,270,238,99
JHC,1,2017,3971,1916,2055,728,323,246,190
PLK,1,2017,1652,802,850,337,189,192,52
PLK,1,2017,2512,1144,1368,589,195,263,89
PLK,1,2017,4325,2289,2036,901,697,850,221
PLK,1,2017,1492,780,712,285,126,123,74
PLK,1,2017,2012,1033,979,411,82,107,82
PLK,1,2017,1166,656,510,230,906,880,42
PLK,1,2017,1903,879,1024,365,245,250,54
KVK,1,2017,2453,1173,1280,537,317,230,94
KVK,1,2017,4672,2188,2484,644,446,382,151
KVK,1,2017,4818,2433,2385,664,231,143,182
ULK,1,2017,7212,3498,3714,1052,323,410,293
ULK,1,2017,7284,3870,3414,1014,533,415,254
ULK,1,2017,5255,2658,2597,857,402,345,227
ULK,1,2017,4481,2264,2217,647,313,151,178
ULK,1,2017,7735,4193,3542,863,224,269,327
ULK,1,2017,6114,3222,2892,875,353,296,270
ULK,1,2017,7107,3381,3726,703,247,235,260
LBK,1,2017,3435,1815,1620,617,277,346,160
LBK,1,2017,3216,1666,1550,450,200,171,183
LBK,1,2017,6965,3656,3309,1042,786,560,301
LBK,1,2017,2771,1308,1463,519,158,208,143
HKK,1,2017,5014,2378,2636,823,1251,677,277
HKK,1,2017,1724,810,914,454,159,158,95
HKK,1,2017,3415,1507,1908,646,355,219,142
HKK,1,2017,1018,566,452,264,328,400,46
HKK,1,2017,3469,1661,1808,605,626,608,160
PAK,1,2017,3451,1471,1980,789,393,311,172
PAK,1,2017,4133,2114,2019,820,1505,832,206
PAK,1,2017,3999,1761,2238,704,359,368,182
PAK,1,2017,3415,1578,1837,749,1204,1117,154
VYS,1,2017,3029,1556,1473,511,167,259,112
VYS,1,2017,3691,1638,2053,728,509,456,171
VYS,1,2017,1659,735,924,402,250,207,74
VYS,1,2017,5231,2522,2709,785,265,227,233
VYS,1,2017,4568,2073,2495,744,304,157,231
JHM,1,2017,3472,1765,1707,464,259,247,177
JHM,1,2017,17302,9039,8263,1883,2056,1403,592
JHM,1,2017,6478,3237,3241,1075,493,943,322
JHM,1,2017,4591,2132,2459,771,512,417,226
JHM,1,2017,8738,3883,4855,1234,522,399,359
JHM,1,2017,2475,1215,1260,500,112,182,124
JHM,1,2017,6825,3199,3626,1140,351,316,247
OLK,1,2017,2620,1110,1510,516,52,63,76
OLK,1,2017,9562,4342,5220,1557,744,939,428
OLK,1,2017,3496,1835,1661,604,334,342,129
OLK,1,2017,6470,3086,3384,882,404,213,276
OLK,1,2017,5266,2406,2860,796,281,198,192
ZLK,1,2017,4556,2161,2395,702,315,355,207
ZLK,1,2017,4594,2205,2389,837,344,336,225
ZLK,1,2017,5848,2574,3274,911,647,525,262
ZLK,1,2017,5397,2566,2831,1011,600,599,230
MSK,1,2017,6315,2907,3408,759,285,257,247
MSK,1,2017,7218,3371,3847,1286,672,645,295
MSK,1,2017,18159,8617,9542,1645,431,421,583
MSK,1,2017,4949,2253,2696,885,619,565,185
MSK,1,2017,7327,3153,4174,1136,577,543,353
MSK,1,2017,20703,10035,10668,2087,854,1404,846
PHA,2,2017,29423,15266,14157,3463,3469,1021,934
STC,2,2017,1862,953,909,285,207,201,65
STC,2,2017,2415,1218,1197,290,197,98,88
STC,2,2017,6531,3366,3165,650,178,220,279
STC,2,2017,3972,2094,1878,432,296,155,154
STC,2,2017,2730,1373,1357,319,183,112,84
STC,2,2017,3994,2214,1780,406,669,305,161
STC,2,2017,2346,1287,1059,264,323,270,73
STC,2,2017,3518,1804,1714,388,764,757,174
STC,2,2017,2207,1228,979,377,454,284,93
STC,2,2017,2639,1442,1197,332,71,77,115
STC,2,2017,4758,2140,2618,480,625,220,181
STC,2,2017,1838,1006,832,198,110,75,85
JHC,2,2017,4693,2285,2408,709,555,690,202
JHC,2,2017,2928,1393,1535,301,204,89,114
JHC,2,2017,2724,1189,1535,298,237,218,87
JHC,2,2017,1972,986,986,293,229,238,77
JHC,2,2017,1565,633,932,228,99,125,71
JHC,2,2017,2398,1092,1306,236,231,202,91
JHC,2,2017,3909,1895,2014,402,225,247,179
PLK,2,2017,1531,753,778,180,213,158,52
PLK,2,2017,2391,1105,1286,273,206,168,82
PLK,2,2017,4130,2184,1946,620,454,550,209
PLK,2,2017,1469,750,719,173,180,104,72
PLK,2,2017,1976,1013,963,236,173,160,74
PLK,2,2017,1135,635,500,145,113,67,40
PLK,2,2017,1825,830,995,183,120,371,49
KVK,2,2017,2413,1113,1300,398,293,173,99
KVK,2,2017,4532,2115,2417,451,377,249,138
KVK,2,2017,4686,2374,2312,522,107,94,178
ULK,2,2017,7212,3445,3767,668,355,225,280
ULK,2,2017,7149,3802,3347,692,572,412,255
ULK,2,2017,5160,2596,2564,548,387,232,212
ULK,2,2017,4466,2238,2228,481,206,199,186
ULK,2,2017,7606,4095,3511,628,174,295,331
ULK,2,2017,5912,3125,2787,509,282,195,257
ULK,2,2017,7119,3396,3723,688,276,214,267
LBK,2,2017,3369,1766,1603,406,224,214,136
LBK,2,2017,3121,1611,1510,319,223,248,173
LBK,2,2017,6855,3592,3263,757,634,751,294
LBK,2,2017,2744,1275,1469,281,128,138,136
HKK,2,2017,4860,2286,2574,520,904,731,263
HKK,2,2017,1679,775,904,241,212,129,90
HKK,2,2017,3303,1432,1871,322,302,251,132
HKK,2,2017,988,547,441,172,309,405,39
HKK,2,2017,3356,1571,1785,379,434,505,143
PAK,2,2017,3276,1393,1883,345,333,257,157
PAK,2,2017,3999,2034,1965,543,1300,969,188
PAK,2,2017,3925,1714,2211,413,400,312,181
PAK,2,2017,3294,1502,1792,429,735,732,143
VYS,2,2017,2858,1451,1407,251,285,151,90
VYS,2,2017,3559,1596,1963,380,432,385,167
VYS,2,2017,1574,686,888,207,178,136,57
VYS,2,2017,5012,2404,2608,363,215,180,218
VYS,2,2017,4379,1995,2384,391,294,195,213
JHM,2,2017,3396,1725,1671,346,283,202,182
JHM,2,2017,16881,8809,8072,1445,1761,1970,596
JHM,2,2017,6312,3125,3187,684,1028,305,307
JHM,2,2017,4433,2045,2388,451,496,430,210
JHM,2,2017,8559,3803,4756,685,512,310,340
JHM,2,2017,2453,1195,1258,318,169,61,128
JHM,2,2017,6825,3215,3610,674,215,145,263
OLK,2,2017,2629,1109,1520,246,78,87,69
OLK,2,2017,9233,4201,5032,891,693,498,396
OLK,2,2017,3379,1790,1589,327,301,311,110
OLK,2,2017,6354,3002,3352,531,348,218,273
OLK,2,2017,5150,2350,2800,491,323,310,182
ZLK,2,2017,4444,2090,2354,376,292,207,213
ZLK,2,2017,4498,2174,2324,505,254,224,224
ZLK,2,2017,5644,2438,3206,509,464,378,242
ZLK,2,2017,5285,2488,2797,623,552,304,227
MSK,2,2017,6144,2815,3329,389,315,275,255
MSK,2,2017,7065,3260,3805,813,684,483,273
MSK,2,2017,17903,8504,9399,1230,443,408,571
MSK,2,2017,4833,2201,2632,527,406,313,181
MSK,2,2017,7096,3076,4020,628,486,413,350
MSK,2,2017,20407,9912,10495,1592,772,658,852
PHA,3,2017,28670,14846,13824,3851,4916,2864,944
STC,3,2017,1690,886,804,273,203,181,58
STC,3,2017,2217,1132,1085,284,267,119,81
STC,3,2017,6379,3342,3037,725,333,343,271
STC,3,2017,3640,1964,1676,477,399,417,150
STC,3,2017,2522,1282,1240,342,327,360,79
STC,3,2017,3804,2128,1676,413,495,493,143
STC,3,2017,2215,1237,978,299,345,238,66
STC,3,2017,3278,1692,1586,352,302,541,149
STC,3,2017,2088,1154,934,384,382,317,95
STC,3,2017,2517,1376,1141,353,172,317,102
STC,3,2017,4194,1956,2238,447,296,495,167
STC,3,2017,1730,971,759,217,130,306,79
JHC,3,2017,4274,2171,2103,689,774,831,212
JHC,3,2017,2629,1339,1290,294,266,300,100
JHC,3,2017,2255,1095,1160,308,305,194,80
JHC,3,2017,1678,901,777,276,403,316,67
JHC,3,2017,1354,609,745,199,124,82,69
JHC,3,2017,2009,994,1015,248,274,187,76
JHC,3,2017,3580,1790,1790,395,287,272,160
PLK,3,2017,1308,702,606,184,208,181,49
PLK,3,2017,2021,1011,1010,269,316,167,88
PLK,3,2017,3947,2108,1839,704,813,717,211
PLK,3,2017,1311,701,610,172,427,209,56
PLK,3,2017,1768,928,840,254,328,200,56
PLK,3,2017,1076,600,476,177,815,112,44
PLK,3,2017,1614,767,847,193,361,204,48
KVK,3,2017,2190,1018,1172,375,353,337,83
KVK,3,2017,4175,1960,2215,437,526,255,128
KVK,3,2017,4449,2267,2182,464,161,141,169
ULK,3,2017,6807,3275,3532,595,342,364,280
ULK,3,2017,6795,3628,3167,749,468,546,247
ULK,3,2017,4632,2377,2255,526,375,402,191
ULK,3,2017,4319,2210,2109,577,383,285,175
ULK,3,2017,7411,3959,3452,752,204,192,313
ULK,3,2017,5629,2957,2672,626,307,274,234
ULK,3,2017,6963,3338,3625,659,307,260,269
LBK,3,2017,3192,1712,1480,487,602,251,119
LBK,3,2017,3023,1556,1467,387,222,200,165
LBK,3,2017,6608,3477,3131,878,1015,613,283
LBK,3,2017,2590,1238,1352,270,195,158,129
HKK,3,2017,4558,2210,2348,566,923,818,261
HKK,3,2017,1521,741,780,232,246,126,77
HKK,3,2017,3061,1366,1695,362,369,294,121
HKK,3,2017,889,515,374,181,249,261,39
HKK,3,2017,3175,1512,1663,409,398,593,131
PAK,3,2017,2820,1295,1525,339,561,232,140
PAK,3,2017,3737,1930,1807,588,1371,606,176
PAK,3,2017,3532,1584,1948,351,550,458,149
PAK,3,2017,2989,1418,1571,435,729,692,143
VYS,3,2017,2491,1350,1141,270,291,172,80
VYS,3,2017,3087,1482,1605,386,516,468,150
VYS,3,2017,1330,607,723,174,202,156,50
VYS,3,2017,4393,2225,2168,419,299,270,189
VYS,3,2017,4098,1911,2187,462,406,287,183
JHM,3,2017,3117,1592,1525,265,297,201,157
JHM,3,2017,16368,8583,7785,1547,1917,1540,590
JHM,3,2017,6007,3038,2969,693,767,785,285
JHM,3,2017,3971,1878,2093,414,575,523,193
JHM,3,2017,7985,3641,4344,703,593,617,325
JHM,3,2017,2234,1138,1096,274,160,132,113
JHM,3,2017,6147,3044,3103,562,335,154,242
OLK,3,2017,2478,1059,1419,248,108,52,58
OLK,3,2017,8544,3988,4556,945,657,454,366
OLK,3,2017,3196,1727,1469,407,378,253,104
OLK,3,2017,5845,2845,3000,511,402,372,250
OLK,3,2017,4783,2210,2573,471,344,258,147
ZLK,3,2017,4133,1980,2153,372,394,284,193
ZLK,3,2017,4058,2017,2041,447,389,273,211
ZLK,3,2017,5226,2270,2956,533,623,569,208
ZLK,3,2017,4800,2305,2495,573,811,815,192
MSK,3,2017,5670,2662,3008,442,422,349,218
MSK,3,2017,6634,3112,3522,882,626,566,241
MSK,3,2017,17617,8296,9321,1363,432,350,523
MSK,3,2017,4602,2157,2445,577,606,656,186
MSK,3,2017,6511,2916,3595,643,517,440,315
MSK,3,2017,19954,9718,10236,1740,915,970,841
PHA,4,2017,27662,14359,13303,3264,3879,1422,901
STC,4,2017,1506,856,650,289,170,173,49
STC,4,2017,2098,1079,1019,255,225,166,73
STC,4,2017,6059,3204,2855,594,249,177,260
STC,4,2017,3272,1864,1408,455,307,241,131
STC,4,2017,2223,1171,1052,273,139,61,70
STC,4,2017,3592,2030,1562,366,435,438,134
STC,4,2017,2120,1202,918,282,380,406,66
STC,4,2017,2989,1594,1395,305,292,338,142
STC,4,2017,1944,1065,879,350,308,265,102
STC,4,2017,2407,1322,1085,285,236,38,90
STC,4,2017,3723,1840,1883,407,206,120,138
STC,4,2017,1589,922,667,204,106,110,62
JHC,4,2017,3793,2024,1769,579,603,534,187
JHC,4,2017,2334,1257,1077,278,236,133,96
JHC,4,2017,1651,907,744,257,211,157,66
JHC,4,2017,1357,775,582,252,190,184,57
JHC,4,2017,1096,566,530,175,125,74,54
JHC,4,2017,1675,903,772,218,200,146,60
JHC,4,2017,3139,1687,1452,338,324,203,143
PLK,4,2017,1163,650,513,158,173,117,45
PLK,4,2017,1667,883,784,231,202,185,76
PLK,4,2017,3699,1992,1707,573,568,326,189
PLK,4,2017,1163,659,504,170,1173,567,48
PLK,4,2017,1581,864,717,243,146,236,65
PLK,4,2017,1006,558,448,125,109,60,35
PLK,4,2017,1385,682,703,176,208,135,42
KVK,4,2017,1936,915,1021,341,361,235,64
KVK,4,2017,3877,1849,2028,398,390,217,112
KVK,4,2017,4107,2137,1970,396,121,118,147
ULK,4,2017,6288,3087,3201,556,294,283,263
ULK,4,2017,6493,3504,2989,661,321,160,235
ULK,4,2017,4104,2181,1923,455,382,202,178
ULK,4,2017,4104,2125,1979,426,225,189,169
ULK,4,2017,7256,3884,3372,617,344,195,290
ULK,4,2017,5355,2852,2503,526,207,229,214
ULK,4,2017,6777,3220,3557,559,230,152,256
LBK,4,2017,2899,1579,1320,415,359,303,112
LBK,4,2017,2837,1470,1367,354,128,161,140
LBK,4,2017,6238,3385,2853,743,605,462,272
LBK,4,2017,2373,1192,1181,329,164,109,124
HKK,4,2017,4149,2065,2084,535,680,757,234
HKK,4,2017,1260,678,582,218,184,140,76
HKK,4,2017,2641,1271,1370,337,288,350,101
HKK,4,2017,796,438,358,194,162,81,30
HKK,4,2017,2844,1468,1376,433,514,354,121
PAK,4,2017,2270,1169,1101,360,299,153,132
PAK,4,2017,3337,1803,1534,576,1196,865,169
PAK,4,2017,2795,1354,1441,322,451,180,145
PAK,4,2017,2641,1303,1338,431,443,337,131
VYS,4,2017,2140,1236,904,229,159,137,77
VYS,4,2017,2713,1435,1278,358,337,369,148
VYS,4,2017,1028,516,512,170,142,197,40
VYS,4,2017,3662,1975,1687,364,204,136,168
VYS,4,2017,3511,1778,1733,372,238,184,153
JHM,4,2017,2898,1507,1391,320,235,212,139
JHM,4,2017,15952,8409,7543,1419,1469,1118,553
JHM,4,2017,5486,2848,2638,616,804,863,264
JHM,4,2017,3274,1663,1611,409,405,387,175
JHM,4,2017,7195,3446,3749,654,393,383,300
JHM,4,2017,2037,1085,952,285,113,96,98
JHM,4,2017,5214,2667,2547,490,256,176,223
OLK,4,2017,2125,978,1147,275,102,67,64
OLK,4,2017,7812,3780,4032,895,665,507,340
OLK,4,2017,2988,1662,1326,338,369,323,99
OLK,4,2017,5320,2724,2596,463,452,213,211
OLK,4,2017,4250,2092,2158,516,321,244,116
ZLK,4,2017,3684,1850,1834,360,339,244,161
ZLK,4,2017,3557,1858,1699,385,218,208,197
ZLK,4,2017,4608,2141,2467,499,406,394,173
ZLK,4,2017,4328,2172,2156,577,680,439,168
MSK,4,2017,5073,2516,2557,561,164,219,180
MSK,4,2017,6329,2973,3356,1125,496,388,210
MSK,4,2017,17340,8208,9132,1270,408,359,516
MSK,4,2017,4086,1982,2104,609,398,368,154
MSK,4,2017,5852,2790,3062,654,346,250,295
MSK,4,2017,19467,9529,9938,1656,747,734,810
PHA,5,2017,26863,14014,12849,3461,6130,1319,793
STC,5,2017,1384,797,587,265,333,199,47
STC,5,2017,2016,1078,938,280,303,127,60
STC,5,2017,5894,3149,2745,602,452,445,235
STC,5,2017,3067,1784,1283,456,564,393,117
STC,5,2017,2061,1159,902,288,258,174,62
STC,5,2017,3418,1953,1465,365,666,345,104
STC,5,2017,2034,1174,860,283,821,395,64
STC,5,2017,2872,1551,1321,356,1212,356,128
STC,5,2017,1893,1048,845,368,613,304,81
STC,5,2017,2257,1238,1019,284,157,73,79
STC,5,2017,3470,1758,1712,414,292,248,124
STC,5,2017,1469,879,590,197,98,90,52
JHC,5,2017,3522,1919,1603,597,869,570,153
JHC,5,2017,2127,1176,951,252,399,234,91
JHC,5,2017,1395,790,605,256,254,217,42
JHC,5,2017,1217,698,519,259,310,207,44
JHC,5,2017,968,523,445,169,403,169,47
JHC,5,2017,1570,849,721,273,298,196,48
JHC,5,2017,2851,1594,1257,337,367,237,134
PLK,5,2017,1052,585,467,153,402,162,40
PLK,5,2017,1500,822,678,264,365,178,67
PLK,5,2017,3577,1986,1591,631,1092,730,167
PLK,5,2017,1108,643,465,174,444,72,45
PLK,5,2017,1521,840,681,244,191,250,48
PLK,5,2017,934,529,405,121,127,724,30
PLK,5,2017,1288,653,635,160,191,125,42
KVK,5,2017,1730,829,901,316,380,274,55
KVK,5,2017,3576,1705,1871,406,589,299,100
KVK,5,2017,3891,2064,1827,442,219,134,143
ULK,5,2017,5838,2909,2929,577,316,177,238
ULK,5,2017,6178,3391,2787,669,506,338,213
ULK,5,2017,3804,2092,1712,463,299,419,162
ULK,5,2017,3877,2042,1835,380,310,277,143
ULK,5,2017,7062,3820,3242,668,277,374,270
ULK,5,2017,5123,2784,2339,503,523,276,194
ULK,5,2017,6482,3111,3371,524,314,301,215
LBK,5,2017,2650,1427,1223,398,425,430,100
LBK,5,2017,2686,1427,1259,314,205,180,119
LBK,5,2017,5943,3299,2644,709,995,741,248
LBK,5,2017,2163,1140,1023,249,200,119,93
HKK,5,2017,3963,2037,1926,521,1034,785,200
HKK,5,2017,1121,622,499,207,225,147,58
HKK,5,2017,2414,1217,1197,346,417,274,91
HKK,5,2017,742,416,326,160,222,227,25
HKK,5,2017,2648,1423,1225,415,443,313,120
PAK,5,2017,2000,1083,917,327,309,166,90
PAK,5,2017,3204,1771,1433,611,1161,784,150
PAK,5,2017,2469,1249,1220,290,416,266,122
PAK,5,2017,2398,1188,1210,363,565,443,113
VYS,5,2017,2033,1191,842,259,318,183,58
VYS,5,2017,2553,1370,1183,365,406,449,128
VYS,5,2017,952,496,456,211,287,113,34
VYS,5,2017,3386,1897,1489,386,156,166,138
VYS,5,2017,3281,1715,1566,386,250,381,150
JHM,5,2017,2681,1436,1245,271,251,256,120
JHM,5,2017,15531,8262,7269,1492,2058,1719,491
JHM,5,2017,5068,2735,2333,566,1016,636,231
JHM,5,2017,2994,1554,1440,430,669,527,149
JHM,5,2017,6607,3270,3337,617,608,420,260
JHM,5,2017,1910,1026,884,281,231,90,75
JHM,5,2017,4665,2448,2217,479,242,195,183
OLK,5,2017,1803,872,931,235,72,50,52
OLK,5,2017,7163,3589,3574,847,839,564,278
OLK,5,2017,2905,1638,1267,371,321,267,83
OLK,5,2017,5088,2665,2423,491,352,195,190
OLK,5,2017,3986,2018,1968,486,321,252,118
ZLK,5,2017,3381,1723,1658,382,314,282,134
ZLK,5,2017,3281,1792,1489,459,329,206,169
ZLK,5,2017,4100,1986,2114,468,589,564,142
ZLK,5,2017,4068,2101,1967,527,785,580,162
MSK,5,2017,4705,2395,2310,537,291,145,170
MSK,5,2017,5986,2879,3107,856,661,585,185
MSK,5,2017,16972,8097,8875,1331,511,241,482
MSK,5,2017,3855,1898,1957,552,421,317,126
MSK,5,2017,5446,2685,2761,621,481,359,267
MSK,5,2017,18831,9333,9498,1614,1033,777,721
PHA,6,2017,26208,13887,12321,3453,4970,3186,721
STC,6,2017,1314,765,549,261,247,172,44
STC,6,2017,1949,1072,877,275,325,204,53
STC,6,2017,5723,3123,2600,593,322,319,204
STC,6,2017,2969,1771,1198,445,629,359,117
STC,6,2017,1957,1135,822,250,242,147,57
STC,6,2017,3355,1939,1416,393,404,443,98
STC,6,2017,2021,1178,843,266,524,287,63
STC,6,2017,2776,1505,1271,326,388,570,115
STC,6,2017,1849,1042,807,334,977,395,69
STC,6,2017,2230,1213,1017,304,199,83,67
STC,6,2017,3285,1696,1589,427,269,112,115
STC,6,2017,1433,881,552,221,78,78,50
JHC,6,2017,3395,1907,1488,647,704,482,148
JHC,6,2017,1952,1103,849,230,325,130,71
JHC,6,2017,1258,720,538,212,222,168,36
JHC,6,2017,1148,666,482,236,265,203,48
JHC,6,2017,931,510,421,150,221,137,40
JHC,6,2017,1547,857,690,259,240,170,61
JHC,6,2017,2707,1538,1169,340,287,159,128
PLK,6,2017,996,585,411,147,313,296,37
PLK,6,2017,1454,814,640,284,248,245,66
PLK,6,2017,3495,1946,1549,673,757,552,145
PLK,6,2017,1041,617,424,140,687,266,37
PLK,6,2017,1491,840,651,236,159,93,54
PLK,6,2017,922,529,393,142,164,89,35
PLK,6,2017,1288,655,633,168,397,115,41
KVK,6,2017,1586,783,803,276,358,312,53
KVK,6,2017,3375,1659,1716,400,446,308,82
KVK,6,2017,3713,1980,1733,390,153,126,128
ULK,6,2017,5543,2831,2712,544,173,139,196
ULK,6,2017,6010,3303,2707,647,326,276,192
ULK,6,2017,3641,2024,1617,451,636,462,142
ULK,6,2017,3660,1960,1700,405,249,144,135
ULK,6,2017,6791,3744,3047,586,315,243,248
ULK,6,2017,4869,2681,2188,498,419,243,155
ULK,6,2017,6209,3043,3166,526,250,219,198
LBK,6,2017,2510,1393,1117,393,344,325,98
LBK,6,2017,2574,1388,1186,331,219,136,102
LBK,6,2017,5762,3263,2499,745,1139,698,214
LBK,6,2017,1975,1081,894,236,331,189,82
HKK,6,2017,3822,2015,1807,498,907,794,184
HKK,6,2017,1100,629,471,245,242,133,61
HKK,6,2017,2379,1238,1141,351,436,296,96
HKK,6,2017,715,411,304,156,179,174,27
HKK,6,2017,2546,1374,1172,361,520,332,105
PAK,6,2017,1916,1044,872,347,325,257,97
PAK,6,2017,3181,1797,1384,597,1447,1120,145
PAK,6,2017,2378,1235,1143,347,328,284,96
PAK,6,2017,2308,1187,1121,400,535,354,99
VYS,6,2017,1960,1180,780,247,200,152,56
VYS,6,2017,2571,1397,1174,432,346,368,111
VYS,6,2017,945,511,434,209,167,104,35
VYS,6,2017,3280,1858,1422,365,193,169,128
VYS,6,2017,3210,1723,1487,396,348,202,120
JHM,6,2017,2569,1405,1164,295,348,222,93
JHM,6,2017,15284,8223,7061,1499,1991,1659,458
JHM,6,2017,4840,2669,2171,627,845,978,188
JHM,6,2017,2844,1496,1348,425,594,481,130
JHM,6,2017,6304,3237,3067,637,434,505,228
JHM,6,2017,1835,1032,803,264,113,137,70
JHM,6,2017,4367,2356,2011,423,300,193,168
OLK,6,2017,1634,779,855,215,164,106,37
OLK,6,2017,6792,3457,3335,826,720,759,264
OLK,6,2017,2728,1558,1170,295,287,172,84
OLK,6,2017,4950,2612,2338,503,370,204,181
OLK,6,2017,3798,1968,1830,477,340,261,127
ZLK,6,2017,3218,1687,1531,383,262,300,124
ZLK,6,2017,3165,1783,1382,465,332,195,164
ZLK,6,2017,3926,1951,1975,489,437,433,137
ZLK,6,2017,3954,2060,1894,556,669,683,169
MSK,6,2017,4459,2332,2127,428,245,285,152
MSK,6,2017,5765,2800,2965,796,499,445,202
MSK,6,2017,16606,8013,8593,1261,531,479,423
MSK,6,2017,3698,1873,1825,535,485,295,114
MSK,6,2017,5210,2615,2595,607,533,555,232
MSK,6,2017,18270,9195,9075,1508,1204,974,659
PHA,7,2017,26878,14620,12258,3915,3552,1661,762
STC,7,2017,1380,810,570,310,166,121,48
STC,7,2017,2061,1151,910,309,281,227,61
STC,7,2017,5724,3173,2551,599,311,505,208
STC,7,2017,3079,1858,1221,474,243,248,119
STC,7,2017,2056,1219,837,330,161,256,68
STC,7,2017,3433,2032,1401,441,500,708,108
STC,7,2017,2157,1279,878,363,315,325,61
STC,7,2017,2859,1583,1276,429,271,376,130
STC,7,2017,1969,1130,839,409,396,176,80
STC,7,2017,2263,1276,987,369,152,16,68
STC,7,2017,3371,1779,1592,484,191,242,125
STC,7,2017,1467,906,561,205,109,89,48
JHC,7,2017,3580,2057,1523,724,497,574,178
JHC,7,2017,1890,1091,799,247,232,163,70
JHC,7,2017,1265,747,518,273,121,147,49
JHC,7,2017,1182,686,496,272,167,161,62
JHC,7,2017,951,531,420,173,175,132,45
JHC,7,2017,1656,948,708,297,233,165,67
JHC,7,2017,2746,1581,1165,418,227,162,133
PLK,7,2017,1032,627,405,175,147,125,40
PLK,7,2017,1480,836,644,279,157,138,56
PLK,7,2017,3626,2071,1555,723,903,342,167
PLK,7,2017,1077,652,425,173,46,206,43
PLK,7,2017,1500,863,637,229,106,81,67
PLK,7,2017,931,542,389,132,704,32,30
PLK,7,2017,1337,698,639,216,134,186,45
KVK,7,2017,1593,820,773,322,174,141,53
KVK,7,2017,3259,1638,1621,380,272,198,79
KVK,7,2017,3604,1928,1676,389,134,64,135
ULK,7,2017,5493,2835,2658,608,195,165,203
ULK,7,2017,5956,3333,2623,671,367,282,208
ULK,7,2017,3714,2117,1597,558,204,261,131
ULK,7,2017,3689,2020,1669,480,325,375,145
ULK,7,2017,6707,3741,2966,579,149,134,240
ULK,7,2017,4786,2669,2117,519,170,376,145
ULK,7,2017,6188,3060,3128,517,168,217,195
LBK,7,2017,2458,1399,1059,407,237,301,100
LBK,7,2017,2664,1473,1191,384,198,181,112
LBK,7,2017,5838,3401,2437,771,967,797,207
LBK,7,2017,2039,1140,899,300,142,102,98
HKK,7,2017,3949,2126,1823,560,811,1140,211
HKK,7,2017,1185,698,487,260,158,134,61
HKK,7,2017,2487,1351,1136,438,247,305,111
HKK,7,2017,786,471,315,215,135,115,28
HKK,7,2017,2624,1464,1160,441,420,508,114
PAK,7,2017,2015,1128,887,392,276,131,111
PAK,7,2017,3391,1983,1408,667,1159,582,157
PAK,7,2017,2540,1411,1129,506,195,162,121
PAK,7,2017,2461,1319,1142,509,547,285,136
VYS,7,2017,2018,1237,781,292,107,107,70
VYS,7,2017,2699,1485,1214,450,332,285,123
VYS,7,2017,1020,583,437,260,112,122,59
VYS,7,2017,3401,1956,1445,487,163,98,168
VYS,7,2017,3304,1811,1493,474,180,259,133
JHM,7,2017,2635,1499,1136,369,135,207,113
JHM,7,2017,15719,8545,7174,1723,1401,1221,521
JHM,7,2017,5016,2842,2174,797,602,642,223
JHM,7,2017,2882,1548,1334,464,444,414,144
JHM,7,2017,6328,3302,3026,715,354,329,270
JHM,7,2017,1916,1104,812,338,125,82,81
JHM,7,2017,4405,2466,1939,539,158,235,164
OLK,7,2017,1592,787,805,221,52,36,37
OLK,7,2017,6785,3571,3214,996,478,408,296
OLK,7,2017,2755,1594,1161,361,323,221,99
OLK,7,2017,5092,2762,2330,603,308,316,204
OLK,7,2017,3904,2069,1835,551,202,149,164
ZLK,7,2017,3289,1771,1518,483,230,244,142
ZLK,7,2017,3292,1902,1390,560,209,162,184
ZLK,7,2017,4047,2071,1976,591,276,262,168
ZLK,7,2017,4143,2235,1908,723,468,263,211
MSK,7,2017,4434,2373,2061,463,162,137,161
MSK,7,2017,5929,2935,2994,982,427,468,264
MSK,7,2017,16625,8146,8479,1395,350,216,471
MSK,7,2017,3840,1972,1868,621,296,412,147
MSK,7,2017,5291,2720,2571,726,486,401,287
MSK,7,2017,18337,9373,8964,1744,978,723,721
PHA,8,2017,26299,14395,11904,3368,3748,2347,777
STC,8,2017,1407,846,561,300,369,257,66
STC,8,2017,2006,1139,867,249,918,782,76
STC,8,2017,5517,3090,2427,554,488,365,195
STC,8,2017,3128,1884,1244,471,333,291,133
STC,8,2017,2013,1200,813,268,179,240,71
STC,8,2017,3361,1964,1397,370,443,324,114
STC,8,2017,2143,1275,868,287,872,307,62
STC,8,2017,2839,1593,1246,384,551,255,146
STC,8,2017,1921,1128,793,374,999,366,85
STC,8,2017,2234,1298,936,313,276,64,72
STC,8,2017,3298,1762,1536,430,286,131,123
STC,8,2017,1387,843,544,168,58,60,48
JHC,8,2017,3592,2060,1532,669,660,818,210
JHC,8,2017,1834,1071,763,226,359,408,70
JHC,8,2017,1300,777,523,292,170,189,57
JHC,8,2017,1112,665,447,212,383,291,67
JHC,8,2017,914,508,406,147,310,63,48
JHC,8,2017,1676,964,712,271,368,167,75
JHC,8,2017,2691,1567,1124,322,304,213,135
PLK,8,2017,1004,611,393,157,223,89,48
PLK,8,2017,1446,833,613,230,242,242,52
PLK,8,2017,3574,2061,1513,643,1008,657,152
PLK,8,2017,1057,641,416,183,674,224,49
PLK,8,2017,1508,854,654,211,250,59,75
PLK,8,2017,917,548,369,147,405,89,36
PLK,8,2017,1325,697,628,176,325,152,42
KVK,8,2017,1534,802,732,291,405,310,50
KVK,8,2017,3151,1600,1551,372,387,205,91
KVK,8,2017,3495,1883,1612,410,235,112,133
ULK,8,2017,5266,2759,2507,501,234,228,192
ULK,8,2017,5712,3204,2508,603,340,271,203
ULK,8,2017,3588,2059,1529,453,493,285,132
ULK,8,2017,3560,1982,1578,375,226,218,140
ULK,8,2017,6596,3677,2919,543,319,345,254
ULK,8,2017,4612,2577,2035,490,342,246,159
ULK,8,2017,5969,2941,3028,487,375,349,173
LBK,8,2017,2391,1358,1033,373,315,352,92
LBK,8,2017,2602,1453,1149,319,205,252,115
LBK,8,2017,5756,3338,2418,742,945,803,215
LBK,8,2017,2048,1147,901,292,368,272,115
HKK,8,2017,3938,2116,1822,505,874,712,225
HKK,8,2017,1160,680,480,213,253,164,70
HKK,8,2017,2482,1356,1126,362,411,276,122
HKK,8,2017,742,454,288,140,217,164,32
HKK,8,2017,2550,1447,1103,338,500,517,135
PAK,8,2017,1991,1140,851,334,296,231,127
PAK,8,2017,3306,1941,1365,539,2166,1617,167
PAK,8,2017,2517,1409,1108,368,334,376,124
PAK,8,2017,2407,1313,1094,397,670,298,127
VYS,8,2017,2014,1247,767,269,159,185,80
VYS,8,2017,2676,1500,1176,415,477,456,125
VYS,8,2017,1037,603,434,207,223,185,61
VYS,8,2017,3400,1955,1445,402,114,93,189
VYS,8,2017,3310,1815,1495,420,234,185,182
JHM,8,2017,2590,1486,1104,308,248,186,131
JHM,8,2017,15290,8371,6919,1384,1903,1535,525
JHM,8,2017,4962,2861,2101,665,1007,651,242
JHM,8,2017,2909,1603,1306,462,603,394,177
JHM,8,2017,6299,3295,3004,690,553,291,310
JHM,8,2017,1927,1104,823,294,117,112,97
JHM,8,2017,4281,2414,1867,451,230,149,174
OLK,8,2017,1475,739,736,155,98,81,33
OLK,8,2017,6623,3557,3066,911,784,531,309
OLK,8,2017,2686,1571,1115,302,337,301,91
OLK,8,2017,4922,2690,2232,448,329,303,208
OLK,8,2017,3793,2028,1765,457,267,137,164
ZLK,8,2017,3209,1731,1478,432,260,222,131
ZLK,8,2017,3221,1863,1358,447,294,229,190
ZLK,8,2017,3927,1981,1946,453,477,283,172
ZLK,8,2017,4016,2168,1848,564,588,662,219
MSK,8,2017,4368,2353,2015,393,265,297,153
MSK,8,2017,5827,2870,2957,845,578,302,269
MSK,8,2017,16223,7931,8292,1228,432,372,491
MSK,8,2017,3780,1934,1846,495,573,327,165
MSK,8,2017,5143,2648,2495,606,356,226,266
MSK,8,2017,18042,9240,8802,1516,955,617,676
PHA,9,2017,24767,13241,11526,3755,2820,3192,824
STC,9,2017,1369,789,580,364,166,188,99
STC,9,2017,1980,1098,882,358,393,333,102
STC,9,2017,5255,2888,2367,620,503,338,235
STC,9,2017,2997,1750,1247,566,503,556,172
STC,9,2017,1937,1121,816,376,115,91,88
STC,9,2017,3318,1899,1419,555,521,537,189
STC,9,2017,2075,1212,863,365,501,214,118
STC,9,2017,2747,1512,1235,517,361,253,141
STC,9,2017,1900,1071,829,456,997,571,99
STC,9,2017,2154,1212,942,389,152,56,97
STC,9,2017,3204,1697,1507,551,219,276,165
STC,9,2017,1319,806,513,255,214,35,61
JHC,9,2017,3426,1908,1518,737,565,364,214
JHC,9,2017,1785,1029,756,288,682,155,98
JHC,9,2017,1267,730,537,307,164,138,77
JHC,9,2017,1055,604,451,300,393,264,91
JHC,9,2017,847,465,382,173,142,151,58
JHC,9,2017,1588,877,711,304,212,240,82
JHC,9,2017,2622,1476,1146,477,233,229,143
PLK,9,2017,996,587,409,227,173,139,70
PLK,9,2017,1391,761,630,328,226,154,104
PLK,9,2017,3350,1897,1453,732,818,573,201
PLK,9,2017,999,581,418,218,918,1040,58
PLK,9,2017,1444,784,660,289,254,90,97
PLK,9,2017,904,518,386,187,272,157,43
PLK,9,2017,1255,645,610,193,416,256,58
KVK,9,2017,1462,746,716,335,291,197,69
KVK,9,2017,3020,1532,1488,476,262,192,125
KVK,9,2017,3399,1788,1611,489,115,92,192
ULK,9,2017,5066,2625,2441,687,133,179,248
ULK,9,2017,5581,3127,2454,750,586,230,282
ULK,9,2017,3429,1908,1521,620,230,317,196
ULK,9,2017,3521,1917,1604,518,246,178,192
ULK,9,2017,6432,3543,2889,727,151,129,324
ULK,9,2017,4407,2446,1961,652,386,211,253
ULK,9,2017,5667,2776,2891,587,223,319,205
LBK,9,2017,2310,1293,1017,514,346,273,154
LBK,9,2017,2553,1420,1133,486,229,117,168
LBK,9,2017,5586,3145,2441,912,1076,722,234
LBK,9,2017,1964,1062,902,319,243,177,140
HKK,9,2017,3750,1983,1767,650,946,866,259
HKK,9,2017,1126,614,512,304,106,137,117
HKK,9,2017,2350,1240,1110,461,255,235,142
HKK,9,2017,715,424,291,217,338,235,59
HKK,9,2017,2434,1338,1096,472,334,265,194
PAK,9,2017,1876,1029,847,466,194,212,183
PAK,9,2017,3040,1719,1321,654,2344,292,212
PAK,9,2017,2273,1186,1087,473,315,331,165
PAK,9,2017,2258,1179,1079,505,458,379,161
VYS,9,2017,1923,1159,764,360,261,204,119
VYS,9,2017,2514,1349,1165,472,311,325,155
VYS,9,2017,981,531,450,248,272,152,78
VYS,9,2017,3219,1821,1398,517,223,165,229
VYS,9,2017,3194,1731,1463,545,221,151,227
JHM,9,2017,2496,1394,1102,401,202,187,174
JHM,9,2017,14598,7875,6723,1675,1815,1422,569
JHM,9,2017,4847,2694,2153,966,878,796,351
JHM,9,2017,2809,1497,1312,561,430,694,217
JHM,9,2017,6090,3125,2965,866,570,407,416
JHM,9,2017,1875,1043,832,349,109,107,128
JHM,9,2017,4206,2323,1883,750,177,183,251
OLK,9,2017,1426,698,728,205,93,70,54
OLK,9,2017,6295,3330,2965,1119,466,624,408
OLK,9,2017,2607,1498,1109,400,240,253,120
OLK,9,2017,4798,2550,2248,679,221,332,289
OLK,9,2017,3602,1849,1753,630,244,227,204
ZLK,9,2017,3022,1586,1436,456,233,223,162
ZLK,9,2017,3049,1706,1343,562,217,245,194
ZLK,9,2017,3818,1827,1991,694,379,365,255
ZLK,9,2017,3839,2028,1811,761,518,189,266
MSK,9,2017,4264,2287,1977,600,180,155,241
MSK,9,2017,5648,2694,2954,1077,504,507,334
MSK,9,2017,15646,7606,8040,1544,371,358,600
MSK,9,2017,3618,1810,1808,622,439,229,201
MSK,9,2017,4924,2465,2459,792,375,478,333
MSK,9,2017,17437,8897,8540,1954,837,795,757
PHA,10,2017,23471,12447,11024,3630,3437,2379,801
STC,10,2017,1286,726,560,290,213,257,84
STC,10,2017,1899,1042,857,321,583,257,104
STC,10,2017,4993,2755,2238,575,623,524,245
STC,10,2017,2851,1646,1205,485,543,491,142
STC,10,2017,1871,1060,811,342,197,164,90
STC,10,2017,3201,1811,1390,432,364,524,179
STC,10,2017,1932,1112,820,288,1034,609,98
STC,10,2017,2631,1427,1204,407,343,420,159
STC,10,2017,1768,967,801,344,1396,414,86
STC,10,2017,2000,1108,892,338,312,192,95
STC,10,2017,3015,1583,1432,464,303,404,154
STC,10,2017,1250,766,484,196,159,119,59
JHC,10,2017,3310,1826,1484,704,606,702,209
JHC,10,2017,1765,1005,760,334,182,81,92
JHC,10,2017,1179,672,507,273,200,259,69
JHC,10,2017,1046,593,453,290,237,220,74
JHC,10,2017,821,441,380,194,179,119,49
JHC,10,2017,1486,811,675,269,217,295,84
JHC,10,2017,2532,1405,1127,415,221,231,149
PLK,10,2017,937,563,374,195,471,354,63
PLK,10,2017,1318,711,607,300,362,188,90
PLK,10,2017,3141,1740,1401,672,1014,809,180
PLK,10,2017,945,544,401,172,1716,1234,53
PLK,10,2017,1335,721,614,229,170,110,81
PLK,10,2017,879,488,391,150,80,136,45
PLK,10,2017,1177,593,584,168,511,129,53
KVK,10,2017,1379,683,696,317,437,342,76
KVK,10,2017,2829,1428,1401,405,508,276,120
KVK,10,2017,3212,1676,1536,444,230,243,172
ULK,10,2017,4819,2494,2325,602,330,492,222
ULK,10,2017,5344,2968,2376,724,622,583,258
ULK,10,2017,3208,1754,1454,504,398,359,171
ULK,10,2017,3297,1802,1495,396,421,346,173
ULK,10,2017,6069,3364,2705,631,297,363,306
ULK,10,2017,4074,2222,1852,561,491,421,239
ULK,10,2017,5373,2660,2713,622,286,239,216
LBK,10,2017,2229,1242,987,476,211,340,148
LBK,10,2017,2363,1307,1056,326,183,384,139
LBK,10,2017,5365,2957,2408,784,873,935,243
LBK,10,2017,1903,1018,885,335,250,141,132
HKK,10,2017,3576,1840,1736,561,912,905,237
HKK,10,2017,1051,571,480,245,215,126,103
HKK,10,2017,2285,1217,1068,425,376,273,134
HKK,10,2017,688,406,282,194,237,275,53
HKK,10,2017,2363,1301,1062,436,445,316,175
PAK,10,2017,1766,938,828,381,232,251,149
PAK,10,2017,2930,1641,1289,619,1299,1327,207
PAK,10,2017,2107,1078,1029,345,331,332,140
PAK,10,2017,2060,1068,992,380,606,483,141
VYS,10,2017,1794,1057,737,262,248,200,99
VYS,10,2017,2376,1257,1119,390,337,378,149
VYS,10,2017,919,511,408,197,382,214,72
VYS,10,2017,3079,1739,1340,424,257,214,199
VYS,10,2017,3092,1675,1417,419,254,309,211
JHM,10,2017,2374,1295,1079,328,196,233,140
JHM,10,2017,13835,7400,6435,1428,1707,1984,541
JHM,10,2017,4618,2503,2115,664,1109,877,297
JHM,10,2017,2772,1436,1336,480,758,547,199
JHM,10,2017,5931,3084,2847,774,588,691,359
JHM,10,2017,1805,1002,803,308,148,136,103
JHM,10,2017,4107,2279,1828,606,140,353,223
OLK,10,2017,1456,710,746,300,51,141,64
OLK,10,2017,6043,3177,2866,964,506,483,372
OLK,10,2017,2517,1432,1085,348,284,258,112
OLK,10,2017,4662,2532,2130,631,341,280,240
OLK,10,2017,3455,1779,1676,511,255,434,183
ZLK,10,2017,2873,1502,1371,405,200,238,143
ZLK,10,2017,2880,1598,1282,432,417,488,183
ZLK,10,2017,3662,1752,1910,526,372,480,230
ZLK,10,2017,3574,1869,1705,523,544,747,214
MSK,10,2017,4090,2203,1887,454,191,182,212
MSK,10,2017,5403,2537,2866,874,540,739,276
MSK,10,2017,14809,7196,7613,1301,453,523,515
MSK,10,2017,3493,1696,1797,575,454,498,187
MSK,10,2017,4676,2366,2310,601,311,437,280
MSK,10,2017,16549,8379,8170,1637,918,602,665
PHA,11,2017,22194,11751,10443,3199,3600,1680,706
STC,11,2017,1270,703,567,308,151,220,60
STC,11,2017,1845,1007,838,270,396,360,93
STC,11,2017,4874,2653,2221,575,368,364,233
STC,11,2017,2779,1546,1233,504,372,428,117
STC,11,2017,1843,1014,829,316,160,142,79
STC,11,2017,3128,1766,1362,441,420,314,158
STC,11,2017,1888,1078,810,287,679,309,81
STC,11,2017,2527,1349,1178,369,301,202,145
STC,11,2017,1679,914,765,347,681,432,68
STC,11,2017,1894,1023,871,317,229,23,76
STC,11,2017,3029,1556,1473,529,255,178,146
STC,11,2017,1237,754,483,208,86,239,50
JHC,11,2017,3308,1798,1510,711,606,541,194
JHC,11,2017,1840,999,841,377,232,172,73
JHC,11,2017,1265,706,559,363,101,148,68
JHC,11,2017,1093,611,482,327,310,250,54
JHC,11,2017,887,452,435,235,128,93,45
JHC,11,2017,1500,785,715,308,148,179,75
JHC,11,2017,2484,1371,1113,383,183,255,124
PLK,11,2017,883,531,352,173,146,168,57
PLK,11,2017,1441,774,667,416,231,329,78
PLK,11,2017,2982,1638,1344,626,917,753,141
PLK,11,2017,949,544,405,197,696,511,37
PLK,11,2017,1357,710,647,272,649,43,57
PLK,11,2017,860,486,374,157,365,143,31
PLK,11,2017,1165,560,605,214,405,72,42
KVK,11,2017,1367,672,695,365,279,350,56
KVK,11,2017,2768,1382,1386,464,406,334,92
KVK,11,2017,3116,1587,1529,428,254,268,142
ULK,11,2017,4831,2502,2329,717,178,115,221
ULK,11,2017,5228,2897,2331,718,557,413,230
ULK,11,2017,3180,1746,1434,548,222,284,171
ULK,11,2017,3264,1746,1518,475,353,299,159
ULK,11,2017,5710,3167,2543,596,182,328,275
ULK,11,2017,3778,2086,1692,511,413,291,176
ULK,11,2017,5032,2476,2556,556,283,204,205
LBK,11,2017,2194,1209,985,436,215,299,138
LBK,11,2017,2290,1256,1034,327,171,153,119
LBK,11,2017,5134,2806,2328,755,879,935,217
LBK,11,2017,1872,966,906,303,198,167,108
HKK,11,2017,3452,1757,1695,537,570,736,212
HKK,11,2017,1053,574,479,249,253,217,74
HKK,11,2017,2279,1159,1120,456,293,264,111
HKK,11,2017,685,390,295,184,92,92,43
HKK,11,2017,2311,1273,1038,398,579,473,145
PAK,11,2017,1790,932,858,440,277,168,109
PAK,11,2017,2903,1612,1291,613,1416,753,180
PAK,11,2017,2209,1094,1115,513,384,314,123
PAK,11,2017,1964,998,966,389,418,450,108
VYS,11,2017,1743,998,745,292,354,284,86
VYS,11,2017,2377,1251,1126,444,305,319,135
VYS,11,2017,891,479,412,202,383,258,63
VYS,11,2017,3138,1745,1393,547,209,133,173
VYS,11,2017,3129,1651,1478,512,192,279,171
JHM,11,2017,2315,1215,1100,335,185,262,114
JHM,11,2017,13326,7093,6233,1372,1596,1685,498
JHM,11,2017,4508,2437,2071,663,539,780,257
JHM,11,2017,2919,1488,1431,629,436,654,178
JHM,11,2017,5855,3007,2848,759,443,389,299
JHM,11,2017,1720,948,772,265,121,142,76
JHM,11,2017,4394,2427,1967,871,128,189,195
OLK,11,2017,1593,768,825,374,84,106,60
OLK,11,2017,5911,3007,2904,1048,762,529,326
OLK,11,2017,2415,1351,1064,302,194,332,90
OLK,11,2017,4524,2447,2077,549,211,318,203
OLK,11,2017,3455,1741,1714,553,206,252,153
ZLK,11,2017,2813,1428,1385,397,151,226,123
ZLK,11,2017,2813,1534,1279,460,169,381,138
ZLK,11,2017,3723,1747,1976,682,351,437,195
ZLK,11,2017,3517,1791,1726,603,629,537,171
MSK,11,2017,4096,2156,1940,534,163,250,172
MSK,11,2017,5361,2438,2923,856,445,403,211
MSK,11,2017,14311,6954,7357,1349,298,443,463
MSK,11,2017,3461,1667,1794,596,251,320,154
MSK,11,2017,4605,2245,2360,670,366,605,247
MSK,11,2017,15945,7980,7965,1505,1018,984,605
PHA,12,2017,21787,11493,10294,2536,2841,1842,653
STC,12,2017,1331,674,657,291,135,191,52
STC,12,2017,1896,996,900,299,309,199,88
STC,12,2017,4984,2667,2317,551,263,285,207
STC,12,2017,3033,1638,1395,610,331,94,116
STC,12,2017,2054,1090,964,423,168,107,77
STC,12,2017,3182,1789,1393,413,369,328,153
STC,12,2017,1924,1080,844,264,454,192,72
STC,12,2017,2655,1373,1282,398,258,315,134
STC,12,2017,1712,935,777,280,588,690,66
STC,12,2017,1923,1017,906,252,213,16,67
STC,12,2017,3340,1595,1745,651,226,184,146
STC,12,2017,1336,784,552,255,68,49,49
JHC,12,2017,3527,1829,1698,740,506,235,171
JHC,12,2017,2064,1041,1023,437,153,106,62
JHC,12,2017,1631,798,833,561,128,83,68
JHC,12,2017,1279,680,599,359,143,177,49
JHC,12,2017,1144,474,670,379,81,107,49
JHC,12,2017,1664,806,858,369,122,169,68
JHC,12,2017,2803,1407,1396,595,109,250,139
PLK,12,2017,993,535,458,242,165,204,62
PLK,12,2017,1695,795,900,488,184,260,68
PLK,12,2017,3066,1641,1425,590,1103,631,115
PLK,12,2017,1033,550,483,213,238,403,36
PLK,12,2017,1476,743,733,297,167,87,50
PLK,12,2017,918,516,402,171,64,38,30
PLK,12,2017,1336,591,745,318,151,114,39
KVK,12,2017,1498,717,781,373,239,296,48
KVK,12,2017,2847,1384,1463,480,273,247,81
KVK,12,2017,3143,1582,1561,416,101,111,126
ULK,12,2017,5009,2516,2493,639,100,85,216
ULK,12,2017,5294,2899,2395,611,280,283,230
ULK,12,2017,3397,1808,1589,580,389,407,164
ULK,12,2017,3375,1730,1645,443,249,233,154
ULK,12,2017,5655,3147,2508,499,115,159,269
ULK,12,2017,3772,2082,1690,554,226,273,135
ULK,12,2017,5020,2462,2558,476,143,166,202
LBK,12,2017,2345,1267,1078,461,242,237,129
LBK,12,2017,2347,1225,1122,335,338,176,114
LBK,12,2017,5164,2790,2374,627,811,610,209
LBK,12,2017,2005,974,1031,387,222,138,96
HKK,12,2017,3662,1738,1924,621,525,511,212
HKK,12,2017,1154,576,578,269,118,180,68
HKK,12,2017,2520,1156,1364,521,199,222,104
HKK,12,2017,750,426,324,196,167,78,41
HKK,12,2017,2397,1249,1148,440,367,433,136
PAK,12,2017,2201,997,1204,673,370,231,106
PAK,12,2017,3094,1633,1461,615,1606,1245,175
PAK,12,2017,2671,1196,1475,717,222,294,116
PAK,12,2017,2186,1052,1134,495,312,237,108
VYS,12,2017,2025,1053,972,471,72,114,88
VYS,12,2017,2737,1289,1448,635,389,236,122
VYS,12,2017,1075,529,546,319,372,412,62
VYS,12,2017,3648,1830,1818,802,132,229,160
VYS,12,2017,3507,1683,1824,627,136,151,166
JHM,12,2017,2508,1271,1237,435,169,112,118
JHM,12,2017,13296,7006,6290,1145,934,825,457
JHM,12,2017,4691,2449,2242,743,954,498,242
JHM,12,2017,3380,1592,1788,788,265,280,185
JHM,12,2017,6576,3102,3474,1205,215,496,288
JHM,12,2017,1816,953,863,316,78,65,63
JHM,12,2017,5023,2493,2530,1021,92,75,201
OLK,12,2017,1987,833,1154,588,44,32,62
OLK,12,2017,6367,3051,3316,1240,261,356,301
OLK,12,2017,2503,1344,1159,388,161,231,91
OLK,12,2017,4851,2493,2358,735,167,198,187
OLK,12,2017,3811,1767,2044,731,166,172,142
ZLK,12,2017,3090,1454,1636,534,106,145,125
ZLK,12,2017,3128,1532,1596,680,169,97,124
ZLK,12,2017,4067,1771,2296,752,245,295,190
ZLK,12,2017,3755,1840,1915,684,318,601,164
MSK,12,2017,4602,2208,2394,876,224,97,183
MSK,12,2017,5768,2506,3262,983,251,253,204
MSK,12,2017,14223,6846,7377,1052,243,178,440
MSK,12,2017,3842,1701,2141,750,263,312,148
MSK,12,2017,5108,2247,2861,993,187,230,232
MSK,12,2017,15944,7894,8050,1375,486,513,570
PHA,1,2018,21729,11398,10331,4173,4771,2931,607
STC,1,2018,1430,683,747,414,417,238,53
STC,1,2018,1898,955,943,376,601,374,75
STC,1,2018,5052,2659,2393,750,511,569,216
STC,1,2018,3163,1653,1510,657,689,725,108
STC,1,2018,2177,1114,1063,465,267,229,81
STC,1,2018,3254,1797,1457,520,630,471,139
STC,1,2018,1940,1062,878,375,709,611,66
STC,1,2018,2765,1421,1344,531,918,305,138
STC,1,2018,1743,940,803,464,1511,1067,72
STC,1,2018,1918,994,924,400,293,135,64
STC,1,2018,3540,1620,1920,763,377,328,129
STC,1,2018,1423,789,634,287,137,96,50
JHC,1,2018,3753,1826,1927,1087,696,640,161
JHC,1,2018,2323,1095,1228,576,395,227,67
JHC,1,2018,1893,836,1057,576,251,219,60
JHC,1,2018,1416,687,729,472,516,332,52
JHC,1,2018,1258,483,775,339,410,325,37
JHC,1,2018,1906,875,1031,517,262,203,63
JHC,1,2018,2986,1385,1601,649,375,242,137
PLK,1,2018,1105,560,545,318,332,216,58
PLK,1,2018,1888,829,1059,534,254,303,71
PLK,1,2018,3036,1587,1449,766,1248,929,102
PLK,1,2018,1107,551,556,279,1058,631,31
PLK,1,2018,1609,778,831,396,647,201,53
PLK,1,2018,948,509,439,196,216,324,35
PLK,1,2018,1415,595,820,303,833,61,36
KVK,1,2018,1574,734,840,464,761,379,47
KVK,1,2018,2947,1393,1554,566,358,192,77
KVK,1,2018,3164,1530,1634,571,331,318,124
ULK,1,2018,5408,2637,2771,1064,291,357,219
ULK,1,2018,5440,2956,2484,914,856,661,225
ULK,1,2018,3516,1811,1705,719,338,250,147
ULK,1,2018,3451,1759,1692,611,418,501,120
ULK,1,2018,5752,3161,2591,858,233,202,267
ULK,1,2018,3912,2079,1833,798,308,265,135
ULK,1,2018,5000,2428,2572,677,246,310,195
LBK,1,2018,2410,1285,1125,561,581,405,125
LBK,1,2018,2381,1195,1186,472,138,170,117
LBK,1,2018,5264,2762,2502,1005,1103,858,213
LBK,1,2018,2072,925,1147,416,587,615,103
HKK,1,2018,3771,1739,2032,758,1319,713,198
HKK,1,2018,1212,596,616,337,128,136,74
HKK,1,2018,2667,1143,1524,596,343,308,95
HKK,1,2018,793,428,365,249,212,264,38
HKK,1,2018,2407,1201,1206,496,662,654,122
PAK,1,2018,2376,1009,1367,655,578,557,96
PAK,1,2018,3144,1596,1548,754,2744,844,144
PAK,1,2018,2896,1241,1655,708,425,276,118
PAK,1,2018,2319,1052,1267,604,589,460,101
VYS,1,2018,2031,1018,1013,413,158,145,60
VYS,1,2018,2834,1270,1564,594,457,442,106
VYS,1,2018,1076,525,551,283,281,347,59
VYS,1,2018,3838,1844,1994,716,287,214,160
VYS,1,2018,3663,1683,1980,700,345,208,144
JHM,1,2018,2564,1263,1301,436,275,308,113
JHM,1,2018,13297,6946,6351,1843,1896,1732,431
JHM,1,2018,4878,2457,2421,982,2439,1124,240
JHM,1,2018,3626,1630,1996,751,745,559,160
JHM,1,2018,6884,3057,3827,1212,646,361,265
JHM,1,2018,1907,974,933,424,98,92,54
JHM,1,2018,5527,2545,2982,1168,304,266,206
OLK,1,2018,2083,819,1264,412,92,70,60
OLK,1,2018,6543,2989,3554,1370,732,608,279
OLK,1,2018,2513,1323,1190,516,335,246,88
OLK,1,2018,4959,2450,2509,817,367,220,188
OLK,1,2018,3937,1752,2185,700,262,240,121
ZLK,1,2018,3182,1459,1723,627,311,241,118
ZLK,1,2018,3253,1523,1730,683,367,209,108
ZLK,1,2018,4190,1766,2424,823,387,274,177
ZLK,1,2018,3881,1830,2051,857,784,442,147
MSK,1,2018,4670,2148,2522,660,366,258,174
MSK,1,2018,5944,2546,3398,1160,473,603,198
MSK,1,2018,14223,6764,7459,1616,441,357,432
MSK,1,2018,3992,1744,2248,800,573,268,140
MSK,1,2018,5236,2230,3006,979,398,272,229
MSK,1,2018,15946,7826,8120,2045,1127,987,560
PHA,2,2018,21263,11029,10234,3025,4619,2761,575
STC,2,2018,1336,640,696,208,315,169,43
STC,2,2018,1846,925,921,251,439,485,65
STC,2,2018,4975,2618,2357,522,440,324,209
STC,2,2018,3069,1611,1458,415,379,245,105
STC,2,2018,2064,1048,1016,242,143,143,72
STC,2,2018,3097,1700,1397,315,559,363,130
STC,2,2018,1893,1054,839,242,619,347,63
STC,2,2018,2727,1385,1342,326,309,319,148
STC,2,2018,1689,926,763,321,1164,486,64
STC,2,2018,1865,974,891,271,162,31,56
STC,2,2018,3438,1567,1871,388,369,234,133
STC,2,2018,1413,784,629,183,285,170,49
JHC,2,2018,3570,1758,1812,566,608,558,148
JHC,2,2018,2252,1063,1189,250,366,341,70
JHC,2,2018,1822,803,1019,243,208,166,64
JHC,2,2018,1362,680,682,241,316,348,56
JHC,2,2018,1212,469,743,176,187,202,40
JHC,2,2018,1825,829,996,229,237,168,69
JHC,2,2018,2915,1361,1554,340,280,272,136
PLK,2,2018,1054,549,505,162,336,148,45
PLK,2,2018,1784,783,1001,216,343,178,64
PLK,2,2018,2913,1522,1391,530,1386,1628,106
PLK,2,2018,1047,537,510,167,323,743,33
PLK,2,2018,1592,750,842,239,179,73,51
PLK,2,2018,925,510,415,128,70,104,40
PLK,2,2018,1352,570,782,168,499,108,35
KVK,2,2018,1511,707,804,299,337,432,41
KVK,2,2018,2865,1363,1502,362,295,233,74
KVK,2,2018,3117,1499,1618,442,155,189,123
ULK,2,2018,5320,2570,2750,596,247,164,226
ULK,2,2018,5291,2884,2407,564,548,249,219
ULK,2,2018,3617,1835,1782,614,236,213,141
ULK,2,2018,3384,1744,1640,362,428,274,120
ULK,2,2018,5695,3128,2567,602,273,214,257
ULK,2,2018,3940,2106,1834,624,231,175,144
ULK,2,2018,4900,2378,2522,524,278,233,186
LBK,2,2018,2350,1225,1125,349,412,345,124
LBK,2,2018,2351,1171,1180,296,151,120,114
LBK,2,2018,5148,2688,2460,644,1262,1102,208
LBK,2,2018,2018,897,1121,243,427,330,94
HKK,2,2018,3619,1652,1967,439,1120,916,184
HKK,2,2018,1171,593,578,184,251,96,72
HKK,2,2018,2604,1125,1479,320,380,182,96
HKK,2,2018,791,414,377,156,328,277,37
HKK,2,2018,2284,1138,1146,302,505,579,106
PAK,2,2018,2247,974,1273,326,537,485,86
PAK,2,2018,3018,1515,1503,485,2088,2033,154
PAK,2,2018,2756,1184,1572,296,392,324,109
PAK,2,2018,2250,1008,1242,357,521,468,98
VYS,2,2018,1939,995,944,254,220,109,63
VYS,2,2018,2692,1226,1466,317,444,471,102
VYS,2,2018,1021,517,504,189,530,192,51
VYS,2,2018,3748,1819,1929,360,196,124,151
VYS,2,2018,3578,1648,1930,388,598,196,160
JHM,2,2018,2469,1190,1279,235,237,206,106
JHM,2,2018,13040,6809,6231,1252,1771,1260,412
JHM,2,2018,4784,2387,2397,611,1301,981,231
JHM,2,2018,3542,1586,1956,390,523,522,152
JHM,2,2018,6706,2971,3735,585,481,396,231
JHM,2,2018,1790,901,889,214,160,183,61
JHM,2,2018,5413,2507,2906,538,231,175,205
OLK,2,2018,2019,792,1227,193,57,47,63
OLK,2,2018,6212,2839,3373,757,873,586,257
OLK,2,2018,2376,1277,1099,291,223,222,76
OLK,2,2018,4754,2371,2383,395,311,199,179
OLK,2,2018,3811,1691,2120,411,231,159,107
ZLK,2,2018,3024,1394,1630,304,198,188,112
ZLK,2,2018,3144,1462,1682,381,274,285,117
ZLK,2,2018,4005,1660,2345,398,453,303,168
ZLK,2,2018,3773,1792,1981,509,595,474,151
MSK,2,2018,4510,2059,2451,377,260,182,172
MSK,2,2018,5737,2432,3305,654,594,508,178
MSK,2,2018,13893,6580,7313,1086,259,240,404
MSK,2,2018,3810,1662,2148,387,505,374,124
MSK,2,2018,5040,2159,2881,506,322,244,207
MSK,2,2018,15522,7636,7886,1346,767,1057,566
PHA,3,2018,20449,10550,9899,2925,5949,3560,559
STC,3,2018,1243,603,640,259,337,490,44
STC,3,2018,1753,919,834,251,526,384,60
STC,3,2018,4920,2594,2326,577,1146,283,207
STC,3,2018,2775,1506,1269,390,493,364,105
STC,3,2018,1869,951,918,219,261,182,63
STC,3,2018,3028,1667,1361,372,613,259,131
STC,3,2018,1804,1004,800,258,1415,528,62
STC,3,2018,2617,1338,1279,338,1026,845,155
STC,3,2018,1653,906,747,328,1555,1214,63
STC,3,2018,1765,940,825,273,276,8,53
STC,3,2018,3110,1474,1636,356,285,311,141
STC,3,2018,1310,759,551,157,200,329,53
JHC,3,2018,3228,1662,1566,561,658,722,162
JHC,3,2018,2055,1020,1035,246,296,245,60
JHC,3,2018,1487,749,738,225,231,253,56
JHC,3,2018,1147,605,542,203,404,385,52
JHC,3,2018,1055,443,612,153,268,119,28
JHC,3,2018,1580,777,803,236,273,249,63
JHC,3,2018,2572,1253,1319,262,393,248,119
PLK,3,2018,928,515,413,149,546,148,39
PLK,3,2018,1538,734,804,234,237,184,61
PLK,3,2018,2759,1465,1294,556,2379,1434,102
PLK,3,2018,920,493,427,146,382,393,29
PLK,3,2018,1483,738,745,206,449,132,47
PLK,3,2018,834,453,381,118,471,920,26
PLK,3,2018,1221,528,693,165,794,310,32
KVK,3,2018,1363,652,711,306,465,330,43
KVK,3,2018,2685,1271,1414,374,500,229,64
KVK,3,2018,2973,1446,1527,392,214,146,105
ULK,3,2018,5025,2473,2552,539,263,253,216
ULK,3,2018,5178,2846,2332,677,677,613,207
ULK,3,2018,3335,1730,1605,424,436,258,123
ULK,3,2018,3196,1682,1514,379,549,229,121
ULK,3,2018,5520,3032,2488,601,179,205,237
ULK,3,2018,3786,2057,1729,498,268,353,147
ULK,3,2018,4840,2347,2493,567,295,214,202
LBK,3,2018,2208,1171,1037,346,538,310,105
LBK,3,2018,2256,1142,1114,269,245,189,112
LBK,3,2018,4973,2599,2374,760,1343,1117,220
LBK,3,2018,1880,842,1038,211,382,294,92
HKK,3,2018,3375,1595,1780,420,1091,951,169
HKK,3,2018,1092,577,515,205,218,77,72
HKK,3,2018,2364,1056,1308,288,421,281,87
HKK,3,2018,709,388,321,144,295,142,28
HKK,3,2018,2171,1089,1082,320,498,502,112
PAK,3,2018,1891,924,967,293,590,177,81
PAK,3,2018,2780,1430,1350,470,2873,1662,140
PAK,3,2018,2489,1097,1392,278,590,395,102
PAK,3,2018,2005,930,1075,306,493,363,97
VYS,3,2018,1715,943,772,206,200,194,69
VYS,3,2018,2495,1179,1316,338,516,405,109
VYS,3,2018,907,489,418,164,428,439,47
VYS,3,2018,3408,1696,1712,346,255,265,166
VYS,3,2018,3226,1565,1661,365,312,317,167
JHM,3,2018,2297,1116,1181,234,204,162,105
JHM,3,2018,12831,6723,6108,1307,1912,1551,430
JHM,3,2018,4493,2250,2243,572,1585,1261,229
JHM,3,2018,3143,1426,1717,345,528,603,153
JHM,3,2018,6182,2866,3316,584,780,490,229
JHM,3,2018,1616,829,787,219,249,80,52
JHM,3,2018,4935,2393,2542,474,313,260,195
OLK,3,2018,1833,744,1089,208,70,86,70
OLK,3,2018,5635,2642,2993,746,557,428,237
OLK,3,2018,2175,1174,1001,274,381,194,58
OLK,3,2018,4388,2246,2142,392,462,451,159
OLK,3,2018,3587,1617,1970,402,227,206,108
ZLK,3,2018,2898,1376,1522,374,319,200,117
ZLK,3,2018,2850,1375,1475,353,347,234,120
ZLK,3,2018,3736,1570,2166,453,428,335,150
ZLK,3,2018,3498,1680,1818,476,546,325,133
MSK,3,2018,4334,2013,2321,365,177,157,181
MSK,3,2018,5368,2333,3035,680,528,399,168
MSK,3,2018,13578,6422,7156,1154,587,257,397
MSK,3,2018,3535,1546,1989,396,527,596,98
MSK,3,2018,4718,2064,2654,530,425,447,202
MSK,3,2018,15030,7410,7620,1526,827,577,555
PHA,4,2018,19917,10201,9716,3050,5249,2693,534
STC,4,2018,1102,568,534,232,399,192,42
STC,4,2018,1668,899,769,250,558,389,49
STC,4,2018,4767,2528,2239,546,531,762,199
STC,4,2018,2617,1451,1166,423,652,486,109
STC,4,2018,1600,857,743,269,327,220,57
STC,4,2018,2829,1599,1230,377,748,337,110
STC,4,2018,1733,965,768,241,790,611,62
STC,4,2018,2435,1266,1169,316,690,539,143
STC,4,2018,1537,853,684,282,1370,830,58
STC,4,2018,1735,942,793,291,223,119,49
STC,4,2018,2808,1347,1461,398,377,141,122
STC,4,2018,1153,675,478,130,138,108,47
JHC,4,2018,2965,1601,1364,612,912,520,151
JHC,4,2018,1732,927,805,234,481,310,52
JHC,4,2018,1095,620,475,259,287,130,48
JHC,4,2018,916,514,402,224,367,346,39
JHC,4,2018,851,404,447,164,144,170,30
JHC,4,2018,1350,704,646,236,317,279,57
JHC,4,2018,2215,1173,1042,320,509,216,109
PLK,4,2018,864,494,370,161,331,115,37
PLK,4,2018,1283,657,626,259,372,472,50
PLK,4,2018,2574,1386,1188,540,1709,900,99
PLK,4,2018,806,454,352,133,322,231,25
PLK,4,2018,1311,685,626,238,362,155,52
PLK,4,2018,847,467,380,167,137,213,32
PLK,4,2018,1070,491,579,158,925,733,34
KVK,4,2018,1211,590,621,265,306,223,42
KVK,4,2018,2520,1242,1278,414,439,295,61
KVK,4,2018,2768,1392,1376,408,184,51,97
ULK,4,2018,4595,2304,2291,548,336,174,214
ULK,4,2018,5012,2744,2268,644,721,948,206
ULK,4,2018,3081,1665,1416,467,368,264,115
ULK,4,2018,2997,1624,1373,404,347,441,123
ULK,4,2018,5303,2947,2356,588,260,302,226
ULK,4,2018,3767,2076,1691,610,291,233,144
ULK,4,2018,4726,2301,2425,535,240,200,184
LBK,4,2018,1972,1084,888,405,533,300,101
LBK,4,2018,2195,1125,1070,354,222,256,107
LBK,4,2018,4717,2526,2191,718,1395,1370,191
LBK,4,2018,1699,815,884,306,389,340,90
HKK,4,2018,3146,1556,1590,486,1118,751,165
HKK,4,2018,945,529,416,174,231,8,55
HKK,4,2018,2067,1002,1065,343,365,187,93
HKK,4,2018,664,367,297,183,230,202,21
HKK,4,2018,1990,1028,962,377,549,265,118
PAK,4,2018,1486,824,662,326,429,735,87
PAK,4,2018,2460,1352,1108,515,2493,1282,138
PAK,4,2018,1906,923,983,284,524,295,90
PAK,4,2018,1763,889,874,390,615,351,90
VYS,4,2018,1542,882,660,235,173,188,63
VYS,4,2018,2244,1117,1127,381,642,535,104
VYS,4,2018,768,426,342,138,482,321,47
VYS,4,2018,2855,1512,1343,336,185,172,132
VYS,4,2018,2766,1450,1316,373,257,216,152
JHM,4,2018,2177,1095,1082,303,385,293,91
JHM,4,2018,12473,6566,5907,1359,1613,1345,421
JHM,4,2018,4159,2173,1986,579,1513,1245,222
JHM,4,2018,2584,1269,1315,411,766,552,139
JHM,4,2018,5598,2731,2867,669,511,550,217
JHM,4,2018,1475,800,675,262,329,133,49
JHM,4,2018,4192,2136,2056,523,348,110,179
OLK,4,2018,1581,640,941,342,85,66,61
OLK,4,2018,5039,2486,2553,833,872,502,210
OLK,4,2018,2005,1126,879,308,485,316,58
OLK,4,2018,3993,2144,1849,491,478,296,151
OLK,4,2018,3109,1502,1607,473,348,295,97
ZLK,4,2018,2599,1293,1306,401,281,256,99
ZLK,4,2018,2526,1315,1211,372,255,179,102
ZLK,4,2018,3321,1473,1848,483,420,318,145
ZLK,4,2018,3135,1569,1566,517,521,638,114
MSK,4,2018,3873,1938,1935,560,243,176,155
MSK,4,2018,4818,2209,2609,712,451,363,146
MSK,4,2018,13282,6304,6978,1192,405,343,376
MSK,4,2018,3230,1531,1699,531,513,383,108
MSK,4,2018,4114,2000,2114,630,529,388,186
MSK,4,2018,14570,7257,7313,1737,924,372,550
PHA,5,2018,19545,10090,9455,3104,6406,2729,479
STC,5,2018,1051,559,492,237,476,219,36
STC,5,2018,1596,875,721,245,561,525,36
STC,5,2018,4630,2485,2145,514,401,450,173
STC,5,2018,2507,1410,1097,373,780,557,82
STC,5,2018,1503,828,675,276,169,198,50
STC,5,2018,2669,1538,1131,346,665,724,107
STC,5,2018,1675,950,725,231,1104,1048,56
STC,5,2018,2336,1251,1085,323,806,366,138
STC,5,2018,1493,853,640,302,1392,1849,50
STC,5,2018,1701,909,792,298,261,764,45
STC,5,2018,2649,1285,1364,396,409,448,99
STC,5,2018,1111,662,449,179,269,184,50
JHC,5,2018,2732,1510,1222,534,911,766,114
JHC,5,2018,1475,838,637,216,524,328,44
JHC,5,2018,888,524,364,171,298,144,33
JHC,5,2018,788,435,353,206,342,349,35
JHC,5,2018,682,353,329,109,432,225,22
JHC,5,2018,1236,666,570,218,276,236,48
JHC,5,2018,2041,1128,913,336,485,344,101
PLK,5,2018,789,468,321,144,631,631,36
PLK,5,2018,1119,573,546,210,302,221,42
PLK,5,2018,2422,1304,1118,575,1781,951,92
PLK,5,2018,774,448,326,169,770,315,33
PLK,5,2018,1232,663,569,210,347,337,51
PLK,5,2018,810,448,362,136,401,99,35
PLK,5,2018,1012,480,532,184,1700,391,29
KVK,5,2018,1155,551,604,276,473,285,42
KVK,5,2018,2363,1204,1159,340,317,276,54
KVK,5,2018,2608,1365,1243,380,203,87,86
ULK,5,2018,4218,2171,2047,500,475,136,167
ULK,5,2018,4787,2662,2125,657,703,680,175
ULK,5,2018,2787,1571,1216,454,434,283,94
ULK,5,2018,2922,1608,1314,395,258,278,114
ULK,5,2018,5228,2903,2325,630,189,116,215
ULK,5,2018,3556,1968,1588,494,294,265,138
ULK,5,2018,4649,2280,2369,518,295,215,167
LBK,5,2018,1860,1032,828,363,748,608,87
LBK,5,2018,2090,1081,1009,304,305,230,90
LBK,5,2018,4545,2483,2062,683,1434,1311,175
LBK,5,2018,1560,779,781,236,406,371,80
HKK,5,2018,2991,1508,1483,460,1122,1091,141
HKK,5,2018,861,503,358,170,136,186,51
HKK,5,2018,1920,962,958,307,318,238,81
HKK,5,2018,647,359,288,169,346,143,23
HKK,5,2018,1930,1035,895,337,603,604,95
PAK,5,2018,1361,778,583,319,552,266,75
PAK,5,2018,2293,1273,1020,460,3301,1564,105
PAK,5,2018,1641,833,808,278,447,287,72
PAK,5,2018,1632,842,790,323,751,398,79
VYS,5,2018,1467,853,614,237,294,135,50
VYS,5,2018,2084,1069,1015,309,1067,470,82
VYS,5,2018,695,391,304,155,605,305,39
VYS,5,2018,2593,1437,1156,324,192,125,106
VYS,5,2018,2602,1393,1209,375,266,183,126
JHM,5,2018,2029,1046,983,267,242,251,68
JHM,5,2018,12147,6482,5665,1318,2152,1629,404
JHM,5,2018,3955,2120,1835,567,1687,1287,188
JHM,5,2018,2353,1197,1156,335,699,738,115
JHM,5,2018,5215,2630,2585,593,754,564,188
JHM,5,2018,1390,762,628,227,161,148,44
JHM,5,2018,3851,2031,1820,508,264,175,141
OLK,5,2018,1336,565,771,189,77,77,42
OLK,5,2018,4702,2402,2300,769,847,600,184
OLK,5,2018,1861,1061,800,297,514,402,41
OLK,5,2018,3736,2044,1692,425,589,588,128
OLK,5,2018,2898,1469,1429,438,292,176,90
ZLK,5,2018,2342,1209,1133,298,230,206,95
ZLK,5,2018,2345,1294,1051,337,526,233,93
ZLK,5,2018,3058,1435,1623,468,700,466,120
ZLK,5,2018,2927,1532,1395,495,946,372,96
MSK,5,2018,3572,1846,1726,449,441,277,134
MSK,5,2018,4578,2124,2454,713,505,417,129
MSK,5,2018,12878,6186,6692,1297,694,620,348
MSK,5,2018,3009,1483,1526,522,556,532,95
MSK,5,2018,3842,1914,1928,509,575,406,165
MSK,5,2018,14097,7075,7022,1515,1333,1383,491
PHA,6,2018,19255,10124,9131,3084,6829,2104,453
STC,6,2018,1034,557,477,228,409,229,34
STC,6,2018,1620,904,716,259,546,357,35
STC,6,2018,4535,2493,2042,485,756,450,163
STC,6,2018,2450,1409,1041,372,499,676,80
STC,6,2018,1470,804,666,236,189,200,43
STC,6,2018,2597,1560,1037,363,700,402,86
STC,6,2018,1672,972,700,231,1324,306,45
STC,6,2018,2251,1235,1016,277,505,952,129
STC,6,2018,1484,852,632,318,1677,865,44
STC,6,2018,1702,944,758,293,528,45,50
STC,6,2018,2562,1280,1282,378,386,394,78
STC,6,2018,1078,657,421,158,311,82,47
JHC,6,2018,2569,1432,1137,527,939,560,110
JHC,6,2018,1323,757,566,177,574,256,42
JHC,6,2018,810,484,326,188,195,100,26
JHC,6,2018,705,407,298,195,264,252,31
JHC,6,2018,632,350,282,145,275,191,20
JHC,6,2018,1192,657,535,211,392,308,44
JHC,6,2018,1932,1064,868,276,949,361,95
PLK,6,2018,768,451,317,137,733,113,32
PLK,6,2018,1094,581,513,253,445,265,37
PLK,6,2018,2471,1352,1119,577,1745,1446,91
PLK,6,2018,723,426,297,131,712,692,25
PLK,6,2018,1209,648,561,236,493,450,46
PLK,6,2018,782,448,334,128,410,286,33
PLK,6,2018,963,468,495,151,2020,220,29
KVK,6,2018,1095,537,558,242,429,410,41
KVK,6,2018,2281,1187,1094,344,410,354,45
KVK,6,2018,2513,1334,1179,368,236,248,79
ULK,6,2018,4011,2104,1907,452,214,231,146
ULK,6,2018,4643,2621,2022,571,1138,483,152
ULK,6,2018,2702,1550,1152,453,386,413,88
ULK,6,2018,2899,1618,1281,392,548,361,105
ULK,6,2018,5100,2877,2223,542,193,163,202
ULK,6,2018,3381,1919,1462,496,273,209,138
ULK,6,2018,4588,2260,2328,504,391,327,158
LBK,6,2018,1801,1019,782,340,546,433,71
LBK,6,2018,2046,1095,951,288,316,243,87
LBK,6,2018,4397,2471,1926,631,1413,1233,158
LBK,6,2018,1525,797,728,245,659,602,71
HKK,6,2018,2965,1526,1439,509,859,596,129
HKK,6,2018,856,507,349,196,337,163,47
HKK,6,2018,1856,957,899,314,435,273,75
HKK,6,2018,618,346,272,128,539,209,24
HKK,6,2018,1872,1028,844,319,458,233,79
PAK,6,2018,1326,775,551,302,391,395,72
PAK,6,2018,2233,1276,957,480,2904,1314,99
PAK,6,2018,1606,809,797,302,279,555,61
PAK,6,2018,1578,829,749,349,892,331,70
VYS,6,2018,1462,875,587,233,196,120,58
VYS,6,2018,2051,1066,985,350,636,706,80
VYS,6,2018,698,407,291,177,463,373,35
VYS,6,2018,2561,1443,1118,317,166,178,105
VYS,6,2018,2567,1389,1178,391,213,219,99
JHM,6,2018,2005,1060,945,285,208,231,69
JHM,6,2018,12126,6529,5597,1391,1712,2006,405
JHM,6,2018,3863,2098,1765,561,2103,1514,160
JHM,6,2018,2326,1199,1127,382,753,672,89
JHM,6,2018,5062,2603,2459,584,717,707,170
JHM,6,2018,1368,755,613,230,151,160,37
JHM,6,2018,3656,1963,1693,412,308,149,114
OLK,6,2018,1246,541,705,191,96,82,28
OLK,6,2018,4556,2354,2202,759,792,783,188
OLK,6,2018,1762,1007,755,282,273,288,39
OLK,6,2018,3671,2024,1647,466,704,592,132
OLK,6,2018,2824,1462,1362,432,310,240,77
ZLK,6,2018,2282,1196,1086,375,272,202,87
ZLK,6,2018,2310,1289,1021,409,354,253,93
ZLK,6,2018,2941,1406,1535,435,630,294,115
ZLK,6,2018,2887,1495,1392,507,633,889,94
MSK,6,2018,3429,1791,1638,393,234,223,124
MSK,6,2018,4402,2064,2338,700,427,504,131
MSK,6,2018,12557,6071,6486,1233,289,385,308
MSK,6,2018,2941,1466,1475,474,756,500,90
MSK,6,2018,3710,1832,1878,565,561,446,140
MSK,6,2018,13748,6969,6779,1527,1418,1096,471
PHA,7,2018,20301,10928,9373,3848,5390,2531,495
STC,7,2018,1118,617,501,293,335,252,40
STC,7,2018,1738,990,748,293,302,493,42
STC,7,2018,4635,2553,2082,577,286,420,166
STC,7,2018,2594,1520,1074,494,488,544,102
STC,7,2018,1557,880,677,318,317,169,51
STC,7,2018,2640,1626,1014,397,685,1142,88
STC,7,2018,1741,1022,719,276,1049,1035,49
STC,7,2018,2380,1321,1059,394,797,749,131
STC,7,2018,1624,963,661,402,1711,1641,52
STC,7,2018,1784,1023,761,337,783,769,57
STC,7,2018,2693,1398,1295,475,272,186,93
STC,7,2018,1132,709,423,195,198,196,43
JHC,7,2018,2647,1524,1123,666,600,627,145
JHC,7,2018,1304,744,560,229,475,272,44
JHC,7,2018,825,510,315,211,460,252,41
JHC,7,2018,812,494,318,266,346,334,53
JHC,7,2018,638,368,270,151,148,147,18
JHC,7,2018,1303,746,557,282,309,418,54
JHC,7,2018,1990,1153,837,390,228,150,122
PLK,7,2018,808,485,323,174,502,430,45
PLK,7,2018,1137,642,495,288,500,251,42
PLK,7,2018,2694,1522,1172,685,1296,1252,108
PLK,7,2018,775,451,324,194,355,221,32
PLK,7,2018,1281,702,579,247,221,182,55
PLK,7,2018,797,453,344,145,157,153,38
PLK,7,2018,1013,521,492,192,989,456,31
KVK,7,2018,1171,595,576,308,299,122,44
KVK,7,2018,2364,1241,1123,457,383,221,43
KVK,7,2018,2499,1349,1150,369,273,227,83
ULK,7,2018,4048,2183,1865,607,206,99,159
ULK,7,2018,4632,2677,1955,621,562,826,161
ULK,7,2018,2848,1660,1188,531,249,159,92
ULK,7,2018,2960,1657,1303,441,416,215,121
ULK,7,2018,5104,2924,2180,581,335,202,193
ULK,7,2018,3444,1967,1477,518,258,153,143
ULK,7,2018,4558,2275,2283,478,176,259,154
LBK,7,2018,1907,1117,790,458,418,369,79
LBK,7,2018,2087,1162,925,346,215,193,91
LBK,7,2018,4476,2584,1892,727,1474,1415,154
LBK,7,2018,1584,866,718,268,215,239,80
HKK,7,2018,3192,1726,1466,632,725,786,173
HKK,7,2018,974,583,391,248,213,136,59
HKK,7,2018,1956,1066,890,434,254,441,83
HKK,7,2018,622,380,242,167,236,358,29
HKK,7,2018,1899,1062,837,348,492,599,74
PAK,7,2018,1424,851,573,402,355,447,84
PAK,7,2018,2419,1417,1002,634,3073,1031,107
PAK,7,2018,1726,949,777,450,427,298,74
PAK,7,2018,1660,897,763,432,449,396,87
VYS,7,2018,1524,923,601,300,260,182,66
VYS,7,2018,2212,1202,1010,456,461,573,83
VYS,7,2018,800,464,336,243,628,459,54
VYS,7,2018,2594,1485,1109,412,94,109,120
VYS,7,2018,2726,1532,1194,521,410,297,142
JHM,7,2018,2099,1136,963,356,167,168,96
JHM,7,2018,12477,6794,5683,1678,1454,1472,454
JHM,7,2018,4072,2302,1770,722,1958,1375,158
JHM,7,2018,2418,1287,1131,443,877,643,106
JHM,7,2018,5194,2725,2469,714,543,463,214
JHM,7,2018,1404,813,591,261,191,108,39
JHM,7,2018,3791,2097,1694,593,157,264,127
OLK,7,2018,1201,550,651,206,58,52,29
OLK,7,2018,4664,2494,2170,891,564,254,221
OLK,7,2018,1766,1034,732,315,321,315,48
OLK,7,2018,3722,2076,1646,478,276,375,163
OLK,7,2018,2909,1538,1371,527,307,224,102
ZLK,7,2018,2296,1248,1048,401,226,275,96
ZLK,7,2018,2459,1414,1045,509,356,139,131
ZLK,7,2018,3104,1551,1553,563,405,325,155
ZLK,7,2018,3126,1694,1432,708,372,217,134
MSK,7,2018,3373,1821,1552,497,169,387,126
MSK,7,2018,4606,2223,2383,882,476,427,174
MSK,7,2018,12666,6193,6473,1378,220,267,340
MSK,7,2018,3130,1606,1524,581,637,486,114
MSK,7,2018,3813,1925,1888,682,340,222,179
MSK,7,2018,13904,7216,6688,1692,970,778,531
PHA,8,2018,20410,11117,9293,3382,5621,5002,551
STC,8,2018,1131,636,495,249,377,562,42
STC,8,2018,1742,975,767,235,414,709,48
STC,8,2018,4609,2564,2045,560,484,433,172
STC,8,2018,2653,1581,1072,442,595,572,121
STC,8,2018,1543,876,667,271,161,196,64
STC,8,2018,2605,1611,994,396,510,500,92
STC,8,2018,1753,1038,715,272,1454,1385,51
STC,8,2018,2419,1351,1068,353,391,382,144
STC,8,2018,1644,972,672,335,1782,1246,53
STC,8,2018,1826,1059,767,322,688,79,63
STC,8,2018,2677,1392,1285,412,345,552,109
STC,8,2018,1099,685,414,163,188,158,38
JHC,8,2018,2674,1564,1110,623,691,645,156
JHC,8,2018,1298,741,557,213,491,745,48
JHC,8,2018,817,503,314,207,164,257,40
JHC,8,2018,790,485,305,212,346,273,57
JHC,8,2018,631,355,276,133,345,319,20
JHC,8,2018,1286,730,556,228,388,237,65
JHC,8,2018,1975,1162,813,343,518,237,133
PLK,8,2018,819,479,340,183,628,251,59
PLK,8,2018,1176,662,514,263,459,371,59
PLK,8,2018,2757,1575,1182,631,1801,1405,126
PLK,8,2018,810,472,338,176,409,760,49
PLK,8,2018,1332,738,594,264,385,695,71
PLK,8,2018,793,463,330,146,458,332,39
PLK,8,2018,1005,521,484,179,1434,2011,35
KVK,8,2018,1145,617,528,257,515,526,42
KVK,8,2018,2323,1237,1086,377,619,568,57
KVK,8,2018,2459,1342,1117,355,312,261,92
ULK,8,2018,4013,2201,1812,536,350,287,147
ULK,8,2018,4642,2704,1938,657,874,343,168
ULK,8,2018,2858,1654,1204,492,379,262,106
ULK,8,2018,3014,1712,1302,467,329,564,144
ULK,8,2018,5088,2929,2159,617,300,244,204
ULK,8,2018,3335,1924,1411,535,345,393,136
ULK,8,2018,4477,2243,2234,438,252,225,161
LBK,8,2018,1908,1103,805,394,254,341,88
LBK,8,2018,2082,1158,924,317,334,341,99
LBK,8,2018,4416,2584,1832,681,1429,1260,164
LBK,8,2018,1571,854,717,255,276,209,87
HKK,8,2018,3266,1804,1462,532,903,1106,214
HKK,8,2018,998,603,395,217,180,223,66
HKK,8,2018,1953,1074,879,364,354,242,84
HKK,8,2018,598,364,234,146,584,462,26
HKK,8,2018,1881,1038,843,313,476,551,85
PAK,8,2018,1434,872,562,357,339,449,103
PAK,8,2018,2453,1446,1007,553,3409,2711,121
PAK,8,2018,1728,964,764,398,345,547,92
PAK,8,2018,1595,868,727,365,633,382,94
VYS,8,2018,1550,943,607,281,154,322,87
VYS,8,2018,2230,1236,994,395,560,454,104
VYS,8,2018,793,466,327,189,594,490,54
VYS,8,2018,2587,1485,1102,374,177,213,138
VYS,8,2018,2755,1548,1207,420,266,330,168
JHM,8,2018,2071,1138,933,274,222,185,106
JHM,8,2018,12414,6818,5596,1411,1732,1445,489
JHM,8,2018,4047,2323,1724,606,1616,2336,193
JHM,8,2018,2385,1298,1087,387,768,495,131
JHM,8,2018,5208,2751,2457,731,661,630,247
JHM,8,2018,1385,808,577,242,131,177,49
JHM,8,2018,3825,2137,1688,536,349,249,157
OLK,8,2018,1172,563,609,178,82,63,37
OLK,8,2018,4607,2475,2132,819,711,697,232
OLK,8,2018,1769,1041,728,362,335,263,43
OLK,8,2018,3689,2068,1621,483,254,379,180
OLK,8,2018,2914,1557,1357,500,232,229,115
ZLK,8,2018,2303,1257,1046,394,246,286,98
ZLK,8,2018,2397,1371,1026,441,409,381,133
ZLK,8,2018,3099,1585,1514,483,620,452,170
ZLK,8,2018,3143,1708,1435,579,745,547,145
MSK,8,2018,3285,1814,1471,385,197,185,138
MSK,8,2018,4516,2218,2298,729,703,553,184
MSK,8,2018,12481,6139,6342,1182,356,313,373
MSK,8,2018,3095,1595,1500,472,676,736,120
MSK,8,2018,3700,1895,1805,544,423,365,174
MSK,8,2018,13568,7073,6495,1452,1139,862,519
PHA,9,2018,19658,10585,9073,3615,4340,5553,712
STC,9,2018,1093,591,502,323,222,375,73
STC,9,2018,1702,929,773,339,435,478,83
STC,9,2018,4449,2471,1978,572,633,526,221
STC,9,2018,2621,1532,1089,571,494,636,168
STC,9,2018,1516,837,679,357,139,266,108
STC,9,2018,2551,1543,1008,490,637,679,144
STC,9,2018,1740,1021,719,333,879,823,92
STC,9,2018,2379,1291,1088,448,655,399,162
STC,9,2018,1600,904,696,422,1783,1437,91
STC,9,2018,1753,996,757,365,830,23,86
STC,9,2018,2640,1360,1280,544,263,144,159
STC,9,2018,1090,652,438,242,151,217,75
JHC,9,2018,2572,1458,1114,695,907,625,200
JHC,9,2018,1313,715,598,281,410,390,87
JHC,9,2018,861,512,349,284,185,313,64
JHC,9,2018,762,448,314,285,362,326,86
JHC,9,2018,605,338,267,168,190,256,35
JHC,9,2018,1298,711,587,324,194,390,97
JHC,9,2018,1941,1132,809,473,326,515,157
PLK,9,2018,832,487,345,225,746,1360,71
PLK,9,2018,1178,645,533,333,284,369,104
PLK,9,2018,2575,1414,1161,655,1761,1296,132
PLK,9,2018,785,438,347,192,505,18,55
PLK,9,2018,1250,674,576,279,213,190,90
PLK,9,2018,795,449,346,175,414,180,49
PLK,9,2018,1008,511,497,238,576,730,66
KVK,9,2018,1150,594,556,337,295,400,88
KVK,9,2018,2257,1189,1068,414,477,526,115
KVK,9,2018,2396,1272,1124,463,191,259,152
ULK,9,2018,3981,2157,1824,729,260,154,234
ULK,9,2018,4614,2661,1953,735,1020,1172,257
ULK,9,2018,2705,1559,1146,553,363,361,157
ULK,9,2018,2984,1651,1333,533,410,295,180
ULK,9,2018,5002,2843,2159,690,392,130,278
ULK,9,2018,3258,1890,1368,559,372,296,220
ULK,9,2018,4341,2181,2160,604,222,196,176
LBK,9,2018,1934,1077,857,522,290,325,127
LBK,9,2018,2067,1141,926,441,384,219,131
LBK,9,2018,4335,2467,1868,872,1250,1428,227
LBK,9,2018,1538,816,722,329,339,350,119
HKK,9,2018,3054,1654,1400,586,686,604,236
HKK,9,2018,989,580,409,297,480,138,93
HKK,9,2018,1888,1001,887,501,202,322,145
HKK,9,2018,644,386,258,244,534,275,72
HKK,9,2018,1822,961,861,452,346,410,121
PAK,9,2018,1352,810,542,452,349,541,144
PAK,9,2018,2348,1327,1021,657,2756,707,175
PAK,9,2018,1629,856,773,405,385,271,114
PAK,9,2018,1547,800,747,462,388,535,142
VYS,9,2018,1497,891,606,326,114,231,120
VYS,9,2018,2235,1184,1051,543,546,468,160
VYS,9,2018,782,433,349,259,275,326,62
VYS,9,2018,2490,1410,1080,465,173,92,198
VYS,9,2018,2647,1445,1202,526,340,216,215
JHM,9,2018,2026,1114,912,373,128,168,148
JHM,9,2018,11936,6534,5402,1638,1694,1141,572
JHM,9,2018,3876,2157,1719,807,1250,1420,277
JHM,9,2018,2366,1271,1095,563,610,835,195
JHM,9,2018,5155,2679,2476,872,625,588,334
JHM,9,2018,1391,784,607,328,160,146,77
JHM,9,2018,3746,2085,1661,690,182,148,254
OLK,9,2018,1088,550,538,226,56,43,76
OLK,9,2018,4458,2290,2168,1024,559,808,311
OLK,9,2018,1725,990,735,387,415,374,75
OLK,9,2018,3609,1979,1630,561,491,344,221
OLK,9,2018,2787,1451,1336,588,216,265,169
ZLK,9,2018,2249,1209,1040,504,217,174,127
ZLK,9,2018,2343,1288,1055,602,322,452,191
ZLK,9,2018,2963,1460,1503,642,403,373,255
ZLK,9,2018,3045,1598,1447,668,502,364,198
MSK,9,2018,3238,1766,1472,512,177,250,181
MSK,9,2018,4453,2186,2267,986,592,459,302
MSK,9,2018,12181,5934,6247,1406,277,416,472
MSK,9,2018,3045,1549,1496,673,670,579,198
MSK,9,2018,3591,1806,1785,731,375,393,244
MSK,9,2018,13007,6768,6239,1659,1088,973,615
PHA,10,2018,18994,10150,8844,3685,5567,4076,702
STC,10,2018,1025,562,463,290,361,263,60
STC,10,2018,1648,888,760,304,470,476,95
STC,10,2018,4316,2391,1925,632,439,529,211
STC,10,2018,2465,1430,1035,476,675,602,148
STC,10,2018,1471,802,669,308,182,130,112
STC,10,2018,2436,1427,1009,462,499,704,148
STC,10,2018,1658,976,682,293,950,886,71
STC,10,2018,2297,1220,1077,370,449,508,163
STC,10,2018,1484,798,686,346,1942,1839,92
STC,10,2018,1657,922,735,325,997,176,79
STC,10,2018,2510,1273,1237,472,374,348,133
STC,10,2018,1012,623,389,191,152,174,74
JHC,10,2018,2496,1378,1118,689,904,1103,191
JHC,10,2018,1297,702,595,316,371,664,72
JHC,10,2018,886,539,347,285,299,332,71
JHC,10,2018,741,454,287,264,335,357,63
JHC,10,2018,604,333,271,184,159,346,35
JHC,10,2018,1263,703,560,289,205,240,89
JHC,10,2018,1856,1064,792,361,369,325,136
PLK,10,2018,776,460,316,171,824,873,51
PLK,10,2018,1120,594,526,286,335,339,84
PLK,10,2018,2470,1326,1144,682,1722,1558,152
PLK,10,2018,724,402,322,152,924,593,53
PLK,10,2018,1205,649,556,283,198,184,80
PLK,10,2018,743,415,328,161,217,246,37
PLK,10,2018,936,471,465,194,1031,1362,58
KVK,10,2018,1078,539,539,331,239,368,76
KVK,10,2018,2236,1162,1074,500,436,532,133
KVK,10,2018,2427,1280,1147,523,244,268,156
ULK,10,2018,3846,2074,1772,645,220,228,224
ULK,10,2018,4372,2486,1886,652,1107,1045,231
ULK,10,2018,2586,1502,1084,525,365,504,136
ULK,10,2018,2866,1599,1267,501,362,400,165
ULK,10,2018,4772,2763,2009,657,285,228,265
ULK,10,2018,3080,1758,1322,596,701,479,210
ULK,10,2018,4144,2091,2053,550,295,253,182
LBK,10,2018,1896,1060,836,493,307,361,131
LBK,10,2018,2036,1115,921,394,331,402,140
LBK,10,2018,4142,2340,1802,790,1113,1358,212
LBK,10,2018,1455,763,692,283,359,396,101
HKK,10,2018,2886,1558,1328,551,896,739,209
HKK,10,2018,965,550,415,268,189,122,94
HKK,10,2018,1869,985,884,466,426,298,134
HKK,10,2018,629,374,255,214,335,290,61
HKK,10,2018,1766,942,824,405,516,494,110
PAK,10,2018,1258,738,520,379,489,444,122
PAK,10,2018,2288,1303,985,638,2819,2738,162
PAK,10,2018,1536,810,726,377,434,482,100
PAK,10,2018,1416,734,682,387,912,687,140
VYS,10,2018,1385,831,554,245,178,180,100
VYS,10,2018,2140,1120,1020,417,762,762,139
VYS,10,2018,688,385,303,190,425,564,43
VYS,10,2018,2423,1381,1042,460,158,111,166
VYS,10,2018,2528,1371,1157,434,394,442,175
JHM,10,2018,1900,1035,865,274,227,302,134
JHM,10,2018,11534,6251,5283,1504,1871,1879,536
JHM,10,2018,3697,2085,1612,658,1386,1649,236
JHM,10,2018,2294,1217,1077,426,677,711,181
JHM,10,2018,5036,2639,2397,735,664,409,304
JHM,10,2018,1315,725,590,246,215,203,69
JHM,10,2018,3732,2065,1667,635,316,332,238
OLK,10,2018,1041,517,524,232,95,100,60
OLK,10,2018,4330,2209,2121,978,773,771,307
OLK,10,2018,1689,959,730,384,351,388,67
OLK,10,2018,3450,1897,1553,561,385,427,208
OLK,10,2018,2725,1402,1323,582,260,489,129
ZLK,10,2018,2084,1103,981,411,273,264,111
ZLK,10,2018,2263,1226,1037,474,390,425,171
ZLK,10,2018,2787,1383,1404,532,473,438,221
ZLK,10,2018,2860,1466,1394,567,551,925,159
MSK,10,2018,3163,1741,1422,515,212,222,162
MSK,10,2018,4234,2110,2124,790,442,576,236
MSK,10,2018,11911,5780,6131,1397,716,394,439
MSK,10,2018,2927,1487,1440,564,466,634,192
MSK,10,2018,3367,1687,1680,584,471,584,206
MSK,10,2018,12480,6431,6049,1802,1352,1531,563
PHA,11,2018,18387,9669,8718,3276,4755,2927,637
STC,11,2018,1013,549,464,282,313,197,43
STC,11,2018,1604,870,734,273,352,503,75
STC,11,2018,4222,2330,1892,535,716,381,189
STC,11,2018,2444,1391,1053,478,768,666,121
STC,11,2018,1523,842,681,356,145,145,100
STC,11,2018,2396,1404,992,498,518,384,119
STC,11,2018,1659,970,689,306,573,956,61
STC,11,2018,2295,1206,1089,405,533,557,148
STC,11,2018,1403,769,634,287,1846,1096,70
STC,11,2018,1642,896,746,302,577,41,70
STC,11,2018,2511,1245,1266,538,393,309,121
STC,11,2018,1040,635,405,221,180,142,66
JHC,11,2018,2539,1379,1160,663,869,803,153
JHC,11,2018,1377,727,650,399,405,389,62
JHC,11,2018,1009,600,409,331,178,302,68
JHC,11,2018,781,448,333,275,282,298,56
JHC,11,2018,672,346,326,218,118,168,35
JHC,11,2018,1305,713,592,293,330,241,73
JHC,11,2018,1817,1013,804,352,246,326,114
PLK,11,2018,790,450,340,189,640,442,50
PLK,11,2018,1250,678,572,410,333,276,68
PLK,11,2018,2424,1281,1143,597,1406,1582,121
PLK,11,2018,719,388,331,160,1136,623,33
PLK,11,2018,1198,643,555,258,267,141,68
PLK,11,2018,762,419,343,173,345,248,27
PLK,11,2018,909,450,459,232,1517,886,55
KVK,11,2018,1059,522,537,311,490,436,52
KVK,11,2018,2275,1178,1097,494,443,334,115
KVK,11,2018,2458,1278,1180,453,88,151,142
ULK,11,2018,3924,2146,1778,744,210,321,217
ULK,11,2018,4362,2498,1864,767,937,710,228
ULK,11,2018,2633,1506,1127,576,248,384,115
ULK,11,2018,2849,1547,1302,447,344,300,150
ULK,11,2018,4629,2659,1970,620,238,244,249
ULK,11,2018,2910,1637,1273,497,346,237,172
ULK,11,2018,4055,2017,2038,565,380,166,165
LBK,11,2018,1886,1049,837,475,652,431,113
LBK,11,2018,2029,1090,939,404,314,371,132
LBK,11,2018,4136,2272,1864,784,1348,1184,209
LBK,11,2018,1446,728,718,281,138,294,81
HKK,11,2018,2773,1494,1279,509,601,753,201
HKK,11,2018,986,563,423,268,186,322,81
HKK,11,2018,1940,973,967,489,330,453,116
HKK,11,2018,652,374,278,226,388,336,37
HKK,11,2018,1750,941,809,398,440,494,103
PAK,11,2018,1368,761,607,492,338,344,103
PAK,11,2018,2344,1289,1055,634,3231,1714,150
PAK,11,2018,1598,813,785,468,495,280,79
PAK,11,2018,1430,731,699,428,397,433,103
VYS,11,2018,1390,820,570,300,185,196,72
VYS,11,2018,2146,1098,1048,416,428,570,129
VYS,11,2018,734,408,326,244,306,242,47
VYS,11,2018,2501,1403,1098,509,154,185,142
VYS,11,2018,2519,1326,1193,448,232,211,138
JHM,11,2018,1830,977,853,284,191,180,112
JHM,11,2018,11325,6150,5175,1385,1461,1550,491
JHM,11,2018,3705,2016,1689,738,1825,1205,200
JHM,11,2018,2466,1266,1200,624,546,573,161
JHM,11,2018,5067,2604,2463,748,464,625,294
JHM,11,2018,1311,716,595,287,215,156,47
JHM,11,2018,3919,2176,1743,806,178,268,213
OLK,11,2018,1348,670,678,515,56,49,61
OLK,11,2018,4206,2104,2102,939,650,580,246
OLK,11,2018,1691,940,751,349,324,287,61
OLK,11,2018,3317,1816,1501,485,398,448,168
OLK,11,2018,2784,1410,1374,606,189,326,129
ZLK,11,2018,2080,1113,967,463,240,266,102
ZLK,11,2018,2240,1202,1038,513,418,455,148
ZLK,11,2018,2852,1341,1511,678,768,781,162
ZLK,11,2018,2738,1385,1353,562,850,683,124
MSK,11,2018,3234,1747,1487,561,199,210,144
MSK,11,2018,4202,2042,2160,809,518,531,165
MSK,11,2018,11793,5665,6128,1324,298,351,409
MSK,11,2018,2942,1459,1483,603,370,408,134
MSK,11,2018,3340,1636,1704,690,338,436,165
MSK,11,2018,12147,6202,5945,1619,966,939,504
PHA,12,2018,18476,9649,8827,2600,4830,2516,592
STC,12,2018,1101,563,538,268,250,503,33
STC,12,2018,1693,901,792,275,293,173,79
STC,12,2018,4298,2341,1957,461,380,344,185
STC,12,2018,2541,1387,1154,493,324,468,98
STC,12,2018,1783,930,853,455,226,175,104
STC,12,2018,2528,1480,1048,400,539,199,127
STC,12,2018,1715,973,742,251,1234,853,48
STC,12,2018,2471,1265,1206,422,502,229,147
STC,12,2018,1443,780,663,270,2011,696,69
STC,12,2018,1638,883,755,217,415,36,66
STC,12,2018,2862,1337,1525,620,255,373,128
STC,12,2018,1165,676,489,243,85,84,60
JHC,12,2018,2732,1432,1300,609,609,853,139
JHC,12,2018,1597,793,804,401,193,300,54
JHC,12,2018,1307,640,667,453,214,161,53
JHC,12,2018,929,503,426,288,206,249,62
JHC,12,2018,903,388,515,317,118,134,40
JHC,12,2018,1521,767,754,375,189,186,86
JHC,12,2018,2071,1080,991,457,270,353,128
PLK,12,2018,898,483,415,218,821,298,54
PLK,12,2018,1501,725,776,456,247,315,60
PLK,12,2018,2538,1319,1219,521,1159,891,120
PLK,12,2018,819,410,409,209,766,657,33
PLK,12,2018,1317,669,648,273,196,170,66
PLK,12,2018,836,451,385,166,302,377,22
PLK,12,2018,1100,496,604,329,558,819,54
KVK,12,2018,1181,581,600,317,208,310,57
KVK,12,2018,2381,1211,1170,461,238,349,105
KVK,12,2018,2667,1362,1305,466,98,86,137
ULK,12,2018,4114,2170,1944,620,219,215,199
ULK,12,2018,4408,2541,1867,587,837,981,216
ULK,12,2018,3006,1655,1351,710,150,328,113
ULK,12,2018,3065,1636,1429,500,341,580,138
ULK,12,2018,4581,2640,1941,473,222,135,232
ULK,12,2018,2961,1658,1303,445,349,451,156
ULK,12,2018,4200,2078,2122,460,212,279,174
LBK,12,2018,2074,1139,935,474,426,373,113
LBK,12,2018,2082,1084,998,308,188,184,120
LBK,12,2018,4311,2300,2011,708,1116,1138,200
LBK,12,2018,1624,775,849,372,222,238,85
HKK,12,2018,3041,1568,1473,577,385,519,172
HKK,12,2018,1033,558,475,213,81,73,81
HKK,12,2018,2273,1054,1219,565,175,283,108
HKK,12,2018,720,402,318,177,235,178,33
HKK,12,2018,1901,978,923,421,325,324,103
PAK,12,2018,1781,834,947,625,488,422,104
PAK,12,2018,2523,1338,1185,553,2140,3655,145
PAK,12,2018,1998,912,1086,588,371,262,73
PAK,12,2018,1612,762,850,437,515,305,98
VYS,12,2018,1587,875,712,359,131,165,78
VYS,12,2018,2454,1125,1329,559,344,438,124
VYS,12,2018,827,408,419,233,326,378,44
VYS,12,2018,2924,1475,1449,675,59,87,142
VYS,12,2018,2836,1362,1474,576,194,262,126
JHM,12,2018,1951,992,959,343,192,245,113
JHM,12,2018,11521,6204,5317,1269,956,1305,475
JHM,12,2018,3988,2087,1901,689,797,1176,187
JHM,12,2018,2931,1393,1538,746,242,302,143
JHM,12,2018,5670,2718,2952,1062,383,638,292
JHM,12,2018,1436,755,681,294,149,89,48
JHM,12,2018,4545,2330,2215,982,125,137,206
OLK,12,2018,1544,703,841,370,80,117,56
OLK,12,2018,4589,2160,2429,1062,360,318,215
OLK,12,2018,1797,990,807,341,327,369,62
OLK,12,2018,3683,1877,1806,702,135,360,171
OLK,12,2018,3188,1483,1705,737,126,149,140
ZLK,12,2018,2347,1167,1180,495,149,151,110
ZLK,12,2018,2481,1233,1248,551,238,406,137
ZLK,12,2018,3199,1392,1807,696,349,222,143
ZLK,12,2018,2927,1445,1482,542,592,200,115
MSK,12,2018,3818,1854,1964,869,119,119,158
MSK,12,2018,4583,2115,2468,907,227,368,152
MSK,12,2018,12019,5730,6289,1096,250,325,375
MSK,12,2018,3245,1488,1757,643,430,647,124
MSK,12,2018,3783,1665,2118,849,444,328,176
MSK,12,2018,12341,6239,6102,1316,608,816,476
PHA,1,2019,18908,9860,9048,4284,7043,5141,552
STC,1,2019,1223,602,621,418,277,309,38
STC,1,2019,1809,948,861,426,487,380,82
STC,1,2019,4389,2352,2037,734,448,370,184
STC,1,2019,2657,1449,1208,611,722,556,103
STC,1,2019,1904,957,947,423,378,248,95
STC,1,2019,2605,1509,1096,529,671,719,128
STC,1,2019,1792,1001,791,387,1156,1266,55
STC,1,2019,2542,1308,1234,509,721,668,136
STC,1,2019,1489,786,703,450,2194,1834,60
STC,1,2019,1695,892,803,382,1026,144,56
STC,1,2019,3095,1415,1680,721,410,216,128
STC,1,2019,1265,711,554,276,235,230,53
JHC,1,2019,3043,1487,1556,1036,1180,802,136
JHC,1,2019,1827,872,955,537,385,243,49
JHC,1,2019,1644,750,894,607,388,271,57
JHC,1,2019,1105,556,549,447,425,438,62
JHC,1,2019,997,391,606,281,286,195,30
JHC,1,2019,1719,817,902,493,279,453,78
JHC,1,2019,2366,1144,1222,709,409,385,124
PLK,1,2019,972,490,482,295,1816,305,49
PLK,1,2019,1702,760,942,511,408,399,61
PLK,1,2019,2715,1402,1313,796,1872,1827,101
PLK,1,2019,881,418,463,242,636,829,40
PLK,1,2019,1432,715,717,391,568,337,65
PLK,1,2019,865,449,416,198,379,497,18
PLK,1,2019,1232,522,710,360,1370,618,43
KVK,1,2019,1338,634,704,468,425,493,57
KVK,1,2019,2572,1237,1335,655,503,276,106
KVK,1,2019,2885,1445,1440,685,212,220,131
ULK,1,2019,4475,2303,2172,987,334,414,203
ULK,1,2019,4618,2614,2004,953,2057,1414,219
ULK,1,2019,3171,1698,1473,706,376,424,109
ULK,1,2019,3257,1698,1559,603,446,464,146
ULK,1,2019,4693,2695,1998,827,353,196,233
ULK,1,2019,3110,1719,1391,755,443,399,160
ULK,1,2019,4276,2103,2173,665,275,205,177
LBK,1,2019,2171,1183,988,550,399,337,110
LBK,1,2019,2157,1096,1061,513,286,222,116
LBK,1,2019,4472,2324,2148,960,1386,1541,189
LBK,1,2019,1757,796,961,471,460,386,90
HKK,1,2019,3251,1606,1645,779,826,671,184
HKK,1,2019,1135,561,574,357,226,480,62
HKK,1,2019,2471,1102,1369,654,351,334,115
HKK,1,2019,814,447,367,283,723,587,33
HKK,1,2019,1983,982,1001,514,464,645,101
PAK,1,2019,2073,917,1156,670,345,518,116
PAK,1,2019,2733,1431,1302,797,3759,6308,147
PAK,1,2019,2288,995,1293,630,454,315,76
PAK,1,2019,1805,815,990,605,510,594,97
VYS,1,2019,1677,882,795,402,194,258,62
VYS,1,2019,2550,1135,1415,580,960,521,115
VYS,1,2019,893,418,475,319,502,628,48
VYS,1,2019,3135,1515,1620,672,260,145,135
VYS,1,2019,3011,1351,1660,676,378,354,116
JHM,1,2019,2057,1015,1042,449,246,184,92
JHM,1,2019,11634,6192,5442,1886,1714,1232,417
JHM,1,2019,4175,2141,2034,939,1766,1420,178
JHM,1,2019,3126,1422,1704,688,697,421,160
JHM,1,2019,6051,2734,3317,1143,729,669,264
JHM,1,2019,1547,792,755,392,323,217,58
JHM,1,2019,5178,2465,2713,1267,311,429,202
OLK,1,2019,1663,712,951,402,80,59,51
OLK,1,2019,4924,2265,2659,1356,514,522,206
OLK,1,2019,1900,1033,867,527,378,385,69
OLK,1,2019,3781,1883,1898,735,446,288,160
OLK,1,2019,3206,1458,1748,678,290,243,134
ZLK,1,2019,2533,1207,1326,628,302,252,118
ZLK,1,2019,2590,1235,1355,662,447,347,129
ZLK,1,2019,3494,1465,2029,840,686,392,156
ZLK,1,2019,3092,1509,1583,819,778,594,98
MSK,1,2019,4037,1868,2169,730,403,325,153
MSK,1,2019,4927,2214,2713,1214,473,611,152
MSK,1,2019,12273,5786,6487,1708,588,508,377
MSK,1,2019,3481,1565,1916,832,468,515,114
MSK,1,2019,4018,1705,2313,906,582,681,173
MSK,1,2019,12726,6370,6356,2078,1386,1317,465
PHA,2,2019,18592,9623,8969,3075,6395,8136,516
STC,2,2019,1242,615,627,238,274,180,43
STC,2,2019,1784,929,855,258,615,418,81
STC,2,2019,4403,2353,2050,556,488,267,181
STC,2,2019,2662,1442,1220,431,484,514,111
STC,2,2019,1900,973,927,263,191,134,89
STC,2,2019,2586,1478,1108,370,471,567,130
STC,2,2019,1746,961,785,244,1469,947,60
STC,2,2019,2446,1266,1180,293,615,855,130
STC,2,2019,1468,769,699,319,3321,1661,59
STC,2,2019,1678,869,809,304,1220,92,57
STC,2,2019,3058,1400,1658,413,615,379,121
STC,2,2019,1251,686,565,159,343,207,52
JHC,2,2019,2961,1450,1511,550,827,709,122
JHC,2,2019,1771,860,911,237,678,427,41
JHC,2,2019,1596,731,865,222,255,211,49
JHC,2,2019,1157,600,557,288,351,428,62
JHC,2,2019,1001,391,610,153,213,170,34
JHC,2,2019,1685,799,886,220,434,223,72
JHC,2,2019,2354,1141,1213,362,409,373,118
PLK,2,2019,935,485,450,154,910,961,46
PLK,2,2019,1626,729,897,225,255,348,65
PLK,2,2019,2746,1421,1325,616,1480,1806,102
PLK,2,2019,837,416,421,134,636,623,36
PLK,2,2019,1455,728,727,246,174,144,62
PLK,2,2019,842,439,403,109,514,247,20
PLK,2,2019,1180,503,677,167,967,1748,39
KVK,2,2019,1324,630,694,303,341,373,42
KVK,2,2019,2564,1224,1340,394,316,489,102
KVK,2,2019,2826,1435,1391,422,134,170,128
ULK,2,2019,4380,2237,2143,550,382,294,191
ULK,2,2019,4560,2546,2014,658,1756,1890,213
ULK,2,2019,3086,1632,1454,400,288,218,107
ULK,2,2019,3272,1712,1560,423,395,352,131
ULK,2,2019,4717,2680,2037,689,264,371,227
ULK,2,2019,3134,1709,1425,556,371,255,156
ULK,2,2019,4461,2174,2287,658,347,338,192
LBK,2,2019,2135,1167,968,404,433,340,117
LBK,2,2019,2126,1063,1063,303,206,246,114
LBK,2,2019,4453,2291,2162,717,1567,1780,188
LBK,2,2019,1760,798,962,247,332,317,89
HKK,2,2019,3215,1571,1644,474,955,756,188
HKK,2,2019,1101,560,541,206,276,358,58
HKK,2,2019,2427,1079,1348,329,283,274,117
HKK,2,2019,774,431,343,148,243,206,26
HKK,2,2019,1932,945,987,317,358,268,102
PAK,2,2019,2036,884,1152,323,362,243,110
PAK,2,2019,2688,1396,1292,485,2944,3810,149
PAK,2,2019,2260,967,1293,342,674,377,72
PAK,2,2019,1767,808,959,357,530,655,87
VYS,2,2019,1604,865,739,201,154,193,63
VYS,2,2019,2456,1089,1367,342,768,570,113
VYS,2,2019,826,402,424,147,584,360,44
VYS,2,2019,3095,1500,1595,377,170,202,135
VYS,2,2019,2921,1327,1594,361,353,222,141
JHM,2,2019,2032,986,1046,284,169,211,108
JHM,2,2019,11498,6116,5382,1412,2025,1347,404
JHM,2,2019,4131,2094,2037,588,1855,2587,164
JHM,2,2019,3089,1398,1691,438,581,615,166
JHM,2,2019,5916,2640,3276,632,722,685,261
JHM,2,2019,1523,766,757,240,197,210,61
JHM,2,2019,5056,2393,2663,526,309,372,218
OLK,2,2019,1610,685,925,169,47,79,41
OLK,2,2019,4740,2188,2552,812,763,931,224
OLK,2,2019,1830,1009,821,325,336,322,61
OLK,2,2019,3720,1868,1852,487,240,391,162
OLK,2,2019,3150,1421,1729,430,211,219,123
ZLK,2,2019,2408,1121,1287,301,272,342,104
ZLK,2,2019,2486,1182,1304,420,353,491,121
ZLK,2,2019,3445,1445,2000,446,529,376,139
ZLK,2,2019,2977,1457,1520,492,870,657,100
MSK,2,2019,3916,1801,2115,429,308,280,152
MSK,2,2019,4795,2149,2646,654,350,309,139
MSK,2,2019,12219,5736,6483,1166,330,299,374
MSK,2,2019,3437,1545,1892,513,452,498,117
MSK,2,2019,3881,1622,2259,475,420,433,173
MSK,2,2019,12696,6362,6334,1411,1476,1191,478
PHA,3,2019,18254,9442,8812,3241,6140,4678,501
STC,3,2019,1168,602,566,254,481,272,40
STC,3,2019,1684,900,784,233,739,619,79
STC,3,2019,4297,2298,1999,529,362,352,177
STC,3,2019,2538,1393,1145,404,569,964,107
STC,3,2019,1724,889,835,253,506,470,87
STC,3,2019,2508,1439,1069,415,526,380,119
STC,3,2019,1632,913,719,254,870,553,59
STC,3,2019,2299,1204,1095,366,695,835,118
STC,3,2019,1408,770,638,322,3065,2186,55
STC,3,2019,1643,868,775,275,1483,85,62
STC,3,2019,2730,1298,1432,346,468,317,108
STC,3,2019,1105,644,461,153,304,390,51
JHC,3,2019,2634,1379,1255,562,778,1004,116
JHC,3,2019,1591,838,753,231,350,436,44
JHC,3,2019,1232,652,580,208,253,326,49
JHC,3,2019,1018,563,455,219,397,323,51
JHC,3,2019,839,369,470,136,264,257,33
JHC,3,2019,1465,755,710,203,347,369,73
JHC,3,2019,2084,1052,1032,322,362,336,105
PLK,3,2019,847,465,382,144,896,1296,44
PLK,3,2019,1380,701,679,222,513,300,58
PLK,3,2019,2737,1444,1293,556,2238,1632,113
PLK,3,2019,771,401,370,155,740,823,31
PLK,3,2019,1349,707,642,227,214,202,55
PLK,3,2019,800,419,381,136,734,434,19
PLK,3,2019,1067,487,580,182,1655,754,33
KVK,3,2019,1253,626,627,326,321,518,43
KVK,3,2019,2289,1146,1143,362,573,333,81
KVK,3,2019,2814,1428,1386,449,138,237,134
ULK,3,2019,4180,2184,1996,594,381,316,185
ULK,3,2019,4712,2664,2048,818,1412,1464,214
ULK,3,2019,2789,1519,1270,441,392,440,95
ULK,3,2019,3208,1705,1503,467,619,310,121
ULK,3,2019,4608,2619,1989,676,300,516,224
ULK,3,2019,2942,1629,1313,498,262,241,128
ULK,3,2019,4486,2205,2281,571,470,379,186
LBK,3,2019,1986,1113,873,367,346,320,106
LBK,3,2019,2051,1043,1008,321,238,177,104
LBK,3,2019,4342,2255,2087,749,1693,1378,182
LBK,3,2019,1642,764,878,235,294,296,84
HKK,3,2019,3024,1528,1496,472,827,618,172
HKK,3,2019,1015,550,465,193,232,248,60
HKK,3,2019,2237,1054,1183,348,355,281,99
HKK,3,2019,730,407,323,169,376,293,27
HKK,3,2019,1843,914,929,370,500,482,99
PAK,3,2019,1685,820,865,312,610,681,101
PAK,3,2019,2474,1327,1147,451,2463,2850,138
PAK,3,2019,2023,925,1098,303,539,612,75
PAK,3,2019,1550,748,802,328,572,458,76
VYS,3,2019,1449,836,613,229,243,192,69
VYS,3,2019,2156,1032,1124,344,634,580,123
VYS,3,2019,732,378,354,167,545,460,34
VYS,3,2019,2803,1459,1344,376,190,124,131
VYS,3,2019,2678,1274,1404,375,256,486,129
JHM,3,2019,1910,914,996,261,146,242,112
JHM,3,2019,11202,5968,5234,1338,1916,1512,404
JHM,3,2019,3951,2064,1887,584,1670,1636,172
JHM,3,2019,2798,1295,1503,391,664,730,164
JHM,3,2019,5512,2560,2952,620,512,617,280
JHM,3,2019,1405,751,654,198,149,218,55
JHM,3,2019,4446,2204,2242,486,373,266,192
OLK,3,2019,1480,674,806,186,116,114,38
OLK,3,2019,4263,2055,2208,704,710,978,213
OLK,3,2019,1711,995,716,322,295,309,60
OLK,3,2019,3362,1808,1554,415,508,250,138
OLK,3,2019,2907,1357,1550,407,210,241,122
ZLK,3,2019,2140,1052,1088,318,280,201,98
ZLK,3,2019,2142,1092,1050,372,423,341,108
ZLK,3,2019,3130,1385,1745,420,664,586,124
ZLK,3,2019,2733,1382,1351,461,887,547,96
MSK,3,2019,3657,1768,1889,459,245,272,146
MSK,3,2019,4506,2022,2484,722,447,370,134
MSK,3,2019,12031,5626,6405,1273,381,341,364
MSK,3,2019,3187,1482,1705,482,590,539,116
MSK,3,2019,3494,1586,1908,511,502,566,154
MSK,3,2019,12581,6404,6177,1623,1065,1504,480
PHA,4,2019,17913,9235,8678,3302,5785,4091,457
STC,4,2019,1045,548,497,285,375,238,27
STC,4,2019,1573,846,727,232,329,608,69
STC,4,2019,4075,2224,1851,498,389,343,151
STC,4,2019,2402,1368,1034,426,752,645,99
STC,4,2019,1543,830,713,256,348,188,81
STC,4,2019,2264,1319,945,382,649,533,106
STC,4,2019,1503,858,645,229,1017,1419,46
STC,4,2019,2050,1136,914,318,610,359,107
STC,4,2019,1389,755,634,351,2621,1945,61
STC,4,2019,1627,876,751,292,1423,518,54
STC,4,2019,2489,1234,1255,466,419,271,104
STC,4,2019,975,564,411,170,132,269,42
JHC,4,2019,2343,1280,1063,553,729,633,98
JHC,4,2019,1393,741,652,255,339,264,44
JHC,4,2019,927,530,397,207,358,292,35
JHC,4,2019,879,494,385,233,360,390,41
JHC,4,2019,717,361,356,201,485,195,32
JHC,4,2019,1260,706,554,232,432,302,61
JHC,4,2019,1845,1017,828,392,424,312,94
PLK,4,2019,798,456,342,157,825,997,44
PLK,4,2019,1218,659,559,295,394,444,49
PLK,4,2019,2730,1469,1261,612,1321,987,116
PLK,4,2019,701,383,318,152,501,786,34
PLK,4,2019,1254,685,569,250,281,203,54
PLK,4,2019,773,422,351,156,472,525,17
PLK,4,2019,945,463,482,178,1188,981,30
KVK,4,2019,1155,579,576,287,352,397,45
KVK,4,2019,2160,1104,1056,420,510,388,81
KVK,4,2019,2727,1417,1310,446,157,191,132
ULK,4,2019,3783,2054,1729,584,397,321,166
ULK,4,2019,4451,2569,1882,674,1339,1192,210
ULK,4,2019,2363,1343,1020,418,300,590,82
ULK,4,2019,2958,1639,1319,395,591,333,119
ULK,4,2019,4489,2577,1912,671,315,281,209
ULK,4,2019,2784,1547,1237,552,217,309,135
ULK,4,2019,4300,2104,2196,447,352,262,171
LBK,4,2019,1808,1027,781,396,530,422,106
LBK,4,2019,1942,1018,924,351,288,250,102
LBK,4,2019,4093,2223,1870,734,1440,1297,175
LBK,4,2019,1461,703,758,280,505,418,74
HKK,4,2019,2855,1507,1348,549,749,655,162
HKK,4,2019,961,539,422,231,225,85,51
HKK,4,2019,1909,958,951,387,249,240,89
HKK,4,2019,644,380,264,173,485,653,26
HKK,4,2019,1732,909,823,401,377,371,91
PAK,4,2019,1379,764,615,303,560,398,96
PAK,4,2019,2232,1230,1002,504,2995,7755,131
PAK,4,2019,1637,804,833,333,531,451,59
PAK,4,2019,1420,733,687,395,508,393,75
VYS,4,2019,1331,792,539,231,200,226,54
VYS,4,2019,1929,987,942,356,420,626,124
VYS,4,2019,656,346,310,177,514,281,32
VYS,4,2019,2386,1332,1054,339,117,106,121
VYS,4,2019,2254,1142,1112,364,262,244,115
JHM,4,2019,1792,878,914,313,223,239,113
JHM,4,2019,10955,5891,5064,1401,1640,1774,385
JHM,4,2019,3755,1982,1773,666,1513,1620,175
JHM,4,2019,2239,1114,1125,386,512,727,143
JHM,4,2019,4898,2445,2453,671,707,693,233
JHM,4,2019,1316,720,596,264,126,190,46
JHM,4,2019,3743,1948,1795,514,325,170,162
OLK,4,2019,1179,582,597,210,148,96,33
OLK,4,2019,3831,1950,1881,780,703,810,200
OLK,4,2019,1585,938,647,301,375,356,48
OLK,4,2019,3054,1703,1351,451,378,548,129
OLK,4,2019,2582,1323,1259,513,219,201,111
ZLK,4,2019,1924,984,940,349,291,265,94
ZLK,4,2019,1947,1059,888,391,401,253,103
ZLK,4,2019,2763,1291,1472,503,707,967,115
ZLK,4,2019,2471,1315,1156,497,1016,542,88
MSK,4,2019,3247,1716,1531,490,319,324,152
MSK,4,2019,4061,1918,2143,695,505,488,138
MSK,4,2019,11853,5524,6329,1271,351,366,353
MSK,4,2019,2927,1458,1469,575,616,562,112
MSK,4,2019,3109,1506,1603,513,736,649,152
MSK,4,2019,12167,6317,5850,1585,1159,1112,483
PHA,5,2019,17821,9218,8603,3178,5417,3367,440
STC,5,2019,1013,535,478,223,323,281,20
STC,5,2019,1546,820,726,231,696,623,73
STC,5,2019,3961,2171,1790,523,567,531,145
STC,5,2019,2313,1348,965,411,807,590,85
STC,5,2019,1429,809,620,269,343,274,66
STC,5,2019,2150,1255,895,367,611,445,91
STC,5,2019,1448,829,619,220,1345,1012,40
STC,5,2019,2002,1092,910,336,895,678,94
STC,5,2019,1376,750,626,315,2933,2834,51
STC,5,2019,1610,871,739,279,920,1380,53
STC,5,2019,2317,1164,1153,388,553,364,90
STC,5,2019,907,529,378,152,290,206,39
JHC,5,2019,2222,1239,983,553,904,782,101
JHC,5,2019,1183,652,531,199,400,571,41
JHC,5,2019,817,475,342,188,327,248,29
JHC,5,2019,784,439,345,178,619,400,30
JHC,5,2019,630,348,282,127,398,257,39
JHC,5,2019,1215,673,542,227,261,290,61
JHC,5,2019,1654,910,744,323,471,359,85
PLK,5,2019,789,464,325,145,1682,311,38
PLK,5,2019,1071,598,473,231,597,375,35
PLK,5,2019,2705,1504,1201,560,1429,1316,126
PLK,5,2019,680,392,288,161,663,738,31
PLK,5,2019,1225,674,551,241,305,889,50
PLK,5,2019,738,403,335,122,290,409,18
PLK,5,2019,929,468,461,195,2326,1525,34
KVK,5,2019,1100,561,539,276,539,372,36
KVK,5,2019,2048,1061,987,404,595,421,59
KVK,5,2019,2602,1375,1227,434,124,166,122
ULK,5,2019,3536,1946,1590,548,277,372,142
ULK,5,2019,4260,2480,1780,623,2003,1860,195
ULK,5,2019,2206,1276,930,415,270,246,69
ULK,5,2019,2782,1550,1232,368,456,667,104
ULK,5,2019,4164,2422,1742,601,413,359,168
ULK,5,2019,2651,1507,1144,510,269,230,123
ULK,5,2019,4077,2057,2020,563,306,278,143
LBK,5,2019,1713,975,738,365,536,475,84
LBK,5,2019,1883,1008,875,359,297,287,97
LBK,5,2019,3919,2166,1753,695,1581,1604,171
LBK,5,2019,1425,730,695,279,454,439,66
HKK,5,2019,2708,1466,1242,465,764,765,134
HKK,5,2019,965,526,439,247,266,194,43
HKK,5,2019,1748,914,834,343,424,239,72
HKK,5,2019,627,380,247,150,624,532,22
HKK,5,2019,1688,879,809,351,419,440,87
PAK,5,2019,1292,709,583,309,394,393,71
PAK,5,2019,2106,1163,943,475,2551,3472,106
PAK,5,2019,1467,754,713,263,465,280,54
PAK,5,2019,1426,763,663,386,522,846,69
VYS,5,2019,1283,756,527,228,158,148,41
VYS,5,2019,1861,963,898,361,466,527,108
VYS,5,2019,633,336,297,159,665,583,22
VYS,5,2019,2202,1249,953,348,208,142,101
VYS,5,2019,2120,1111,1009,364,459,389,107
JHM,5,2019,1698,851,847,261,197,222,93
JHM,5,2019,10700,5796,4904,1335,1668,1665,353
JHM,5,2019,3554,1939,1615,567,1772,1510,136
JHM,5,2019,2023,1022,1001,330,699,621,105
JHM,5,2019,4536,2340,2196,564,655,800,194
JHM,5,2019,1266,685,581,200,154,110,42
JHM,5,2019,3296,1768,1528,439,529,486,127
OLK,5,2019,1060,527,533,204,72,154,30
OLK,5,2019,3686,1924,1762,836,714,739,175
OLK,5,2019,1508,883,625,311,428,235,42
OLK,5,2019,2918,1623,1295,453,517,462,119
OLK,5,2019,2429,1282,1147,463,300,219,93
ZLK,5,2019,1795,921,874,361,307,224,74
ZLK,5,2019,1884,1027,857,380,508,376,91
ZLK,5,2019,2595,1245,1350,473,674,509,107
ZLK,5,2019,2428,1302,1126,500,1045,836,81
MSK,5,2019,3034,1633,1401,444,445,266,129
MSK,5,2019,3905,1837,2068,673,403,362,127
MSK,5,2019,11645,5478,6167,1267,308,418,331
MSK,5,2019,2763,1396,1367,515,661,762,106
MSK,5,2019,2893,1421,1472,472,575,438,135
MSK,5,2019,12032,6238,5794,1609,1326,1006,432
PHA,6,2019,17771,9314,8457,2988,4441,4426,432
STC,6,2019,1019,551,468,228,376,248,18
STC,6,2019,1549,834,715,252,474,363,62
STC,6,2019,3899,2175,1724,506,628,266,134
STC,6,2019,2274,1308,966,396,646,664,88
STC,6,2019,1382,798,584,248,205,197,62
STC,6,2019,2110,1237,873,356,701,451,72
STC,6,2019,1475,843,632,270,992,855,42
STC,6,2019,2049,1123,926,347,690,554,96
STC,6,2019,1372,755,617,308,2702,2454,45
STC,6,2019,1540,850,690,278,1198,5769,52
STC,6,2019,2362,1214,1148,435,459,304,72
STC,6,2019,898,541,357,148,205,218,38
JHC,6,2019,2214,1257,957,559,732,842,101
JHC,6,2019,1087,608,479,172,334,429,30
JHC,6,2019,740,437,303,176,221,286,26
JHC,6,2019,765,451,314,194,523,326,27
JHC,6,2019,613,329,284,136,140,328,36
JHC,6,2019,1188,668,520,214,317,312,48
JHC,6,2019,1627,905,722,270,332,402,80
PLK,6,2019,775,448,327,158,1044,1155,39
PLK,6,2019,1056,597,459,234,528,235,31
PLK,6,2019,2808,1559,1249,580,1461,2313,128
PLK,6,2019,694,403,291,151,466,939,20
PLK,6,2019,1217,697,520,207,343,351,45
PLK,6,2019,769,415,354,156,154,557,17
PLK,6,2019,928,457,471,177,730,1266,31
KVK,6,2019,1076,561,515,252,424,320,37
KVK,6,2019,1964,1021,943,389,514,800,40
KVK,6,2019,2491,1340,1151,365,125,138,112
ULK,6,2019,3385,1877,1508,470,292,224,128
ULK,6,2019,4123,2412,1711,550,1159,783,161
ULK,6,2019,2144,1260,884,437,308,457,65
ULK,6,2019,2705,1518,1187,369,355,432,108
ULK,6,2019,3809,2277,1532,560,268,210,136
ULK,6,2019,2542,1447,1095,453,282,335,100
ULK,6,2019,3690,1947,1743,454,420,297,108
LBK,6,2019,1671,939,732,350,264,402,74
LBK,6,2019,1810,995,815,278,378,142,76
LBK,6,2019,3817,2144,1673,672,1222,1286,153
LBK,6,2019,1349,713,636,184,269,313,56
HKK,6,2019,2615,1419,1196,428,752,549,123
HKK,6,2019,957,524,433,207,248,131,47
HKK,6,2019,1686,895,791,306,372,236,61
HKK,6,2019,592,338,254,124,417,521,15
HKK,6,2019,1668,917,751,345,313,306,86
PAK,6,2019,1239,693,546,273,493,367,67
PAK,6,2019,2083,1180,903,467,2959,3455,103
PAK,6,2019,1423,722,701,287,464,395,48
PAK,6,2019,1447,793,654,375,576,614,71
VYS,6,2019,1269,754,515,206,257,138,34
VYS,6,2019,1859,1000,859,341,551,500,87
VYS,6,2019,637,351,286,150,533,484,20
VYS,6,2019,2173,1259,914,332,162,161,80
VYS,6,2019,2140,1101,1039,357,238,262,94
JHM,6,2019,1655,835,820,219,149,148,87
JHM,6,2019,10484,5735,4749,1229,1825,1045,359
JHM,6,2019,3523,1931,1592,566,1983,1344,129
JHM,6,2019,1967,1022,945,338,619,616,84
JHM,6,2019,4357,2252,2105,539,596,530,154
JHM,6,2019,1217,670,547,184,269,126,30
JHM,6,2019,3029,1644,1385,408,288,265,108
OLK,6,2019,958,480,478,157,100,63,24
OLK,6,2019,3617,1916,1701,753,724,703,158
OLK,6,2019,1442,832,610,286,457,322,34
OLK,6,2019,2743,1588,1155,357,377,446,92
OLK,6,2019,2283,1244,1039,404,201,194,78
ZLK,6,2019,1745,931,814,326,173,181,54
ZLK,6,2019,1872,1043,829,387,351,451,93
ZLK,6,2019,2515,1217,1298,427,512,772,95
ZLK,6,2019,2408,1304,1104,483,1031,1419,76
MSK,6,2019,2906,1587,1319,395,187,253,109
MSK,6,2019,3900,1851,2049,752,393,312,119
MSK,6,2019,11379,5403,5976,1098,422,476,314
MSK,6,2019,2687,1383,1304,459,424,462,91
MSK,6,2019,2769,1372,1397,429,437,392,114
MSK,6,2019,11722,6133,5589,1365,1225,1154,395
PHA,7,2019,18895,10183,8712,3969,4491,2900,488
STC,7,2019,1139,629,510,324,360,405,21
STC,7,2019,1616,879,737,287,774,488,56
STC,7,2019,4007,2264,1743,631,576,297,143
STC,7,2019,2434,1456,978,534,717,579,110
STC,7,2019,1509,900,609,361,600,204,59
STC,7,2019,2149,1293,856,421,556,598,75
STC,7,2019,1539,885,654,304,1452,1127,35
STC,7,2019,2181,1229,952,435,717,630,105
STC,7,2019,1482,892,590,422,2894,2715,44
STC,7,2019,1626,918,708,390,1761,3522,55
STC,7,2019,2517,1339,1178,508,466,119,75
STC,7,2019,940,580,360,209,191,263,45
JHC,7,2019,2386,1391,995,738,709,736,119
JHC,7,2019,1119,638,481,250,477,344,30
JHC,7,2019,773,481,292,243,307,515,32
JHC,7,2019,817,502,315,281,333,437,40
JHC,7,2019,625,339,286,170,348,231,38
JHC,7,2019,1261,733,528,306,512,315,58
JHC,7,2019,1776,1037,739,433,367,297,91
PLK,7,2019,774,471,303,174,1069,1496,39
PLK,7,2019,1143,674,469,309,591,489,49
PLK,7,2019,3034,1734,1300,727,1948,1564,133
PLK,7,2019,743,439,304,187,771,612,28
PLK,7,2019,1289,739,550,294,232,252,51
PLK,7,2019,812,467,345,170,368,618,25
PLK,7,2019,960,500,460,209,1853,1221,29
KVK,7,2019,1074,591,483,279,398,308,27
KVK,7,2019,2019,1099,920,477,310,634,44
KVK,7,2019,2494,1365,1129,467,102,90,107
ULK,7,2019,3358,1903,1455,560,186,243,120
ULK,7,2019,4244,2505,1739,710,939,653,170
ULK,7,2019,2245,1346,899,521,364,201,78
ULK,7,2019,2780,1592,1188,455,302,423,111
ULK,7,2019,3894,2357,1537,685,284,294,143
ULK,7,2019,2548,1457,1091,526,428,227,106
ULK,7,2019,3837,2033,1804,593,338,439,126
LBK,7,2019,1737,1005,732,445,307,640,73
LBK,7,2019,1896,1070,826,401,254,294,77
LBK,7,2019,4011,2307,1704,836,1655,1533,146
LBK,7,2019,1433,786,647,296,476,186,69
HKK,7,2019,2817,1581,1236,609,699,575,170
HKK,7,2019,1035,581,454,264,300,223,48
HKK,7,2019,1816,1003,813,479,290,344,75
HKK,7,2019,691,423,268,220,509,507,27
HKK,7,2019,1750,988,762,401,461,523,94
PAK,7,2019,1404,843,561,442,413,426,79
PAK,7,2019,2272,1336,936,650,2737,2651,114
PAK,7,2019,1557,856,701,460,464,527,64
PAK,7,2019,1599,891,708,480,621,583,75
VYS,7,2019,1376,828,548,326,220,266,54
VYS,7,2019,2083,1159,924,538,516,492,103
VYS,7,2019,688,391,297,226,527,422,32
VYS,7,2019,2317,1367,950,461,154,302,96
VYS,7,2019,2272,1221,1051,448,211,254,113
JHM,7,2019,1745,923,822,343,204,224,97
JHM,7,2019,11077,6177,4900,1860,1663,1688,410
JHM,7,2019,3786,2095,1691,826,2274,1634,147
JHM,7,2019,2087,1124,963,470,739,637,94
JHM,7,2019,4537,2378,2159,782,864,803,200
JHM,7,2019,1279,743,536,280,85,98,38
JHM,7,2019,3117,1745,1372,562,182,381,113
OLK,7,2019,918,477,441,193,68,27,36
OLK,7,2019,3777,2053,1724,971,779,969,177
OLK,7,2019,1475,871,604,352,281,353,42
OLK,7,2019,2780,1616,1164,530,361,340,97
OLK,7,2019,2482,1403,1079,599,175,169,116
ZLK,7,2019,1808,999,809,462,230,238,74
ZLK,7,2019,2038,1182,856,533,427,361,121
ZLK,7,2019,2618,1318,1300,580,646,428,119
ZLK,7,2019,2659,1463,1196,742,1190,775,105
MSK,7,2019,2937,1665,1272,514,336,246,102
MSK,7,2019,4074,2037,2037,862,448,359,150
MSK,7,2019,11416,5490,5926,1385,319,445,345
MSK,7,2019,2889,1503,1386,648,748,788,102
MSK,7,2019,2881,1500,1381,630,703,633,140
MSK,7,2019,11947,6345,5602,1818,1551,1295,422
PHA,8,2019,19089,10403,8686,3213,3597,3187,545
STC,8,2019,1120,610,510,221,367,393,23
STC,8,2019,1643,905,738,285,365,443,66
STC,8,2019,4014,2286,1728,525,1308,476,142
STC,8,2019,2436,1494,942,408,511,769,120
STC,8,2019,1511,875,636,258,188,188,62
STC,8,2019,2198,1314,884,415,706,558,81
STC,8,2019,1564,895,669,267,865,1257,38
STC,8,2019,2210,1245,965,387,803,905,98
STC,8,2019,1528,943,585,358,3385,1913,51
STC,8,2019,1643,921,722,311,1372,648,49
STC,8,2019,2504,1326,1178,395,419,567,80
STC,8,2019,948,582,366,182,201,177,51
JHC,8,2019,2353,1377,976,549,884,619,128
JHC,8,2019,1148,663,485,217,355,241,37
JHC,8,2019,806,483,323,204,179,250,35
JHC,8,2019,802,476,326,196,617,505,39
JHC,8,2019,628,345,283,143,275,209,40
JHC,8,2019,1315,781,534,250,429,448,70
JHC,8,2019,1779,1039,740,325,577,209,97
PLK,8,2019,800,482,318,162,878,467,38
PLK,8,2019,1148,680,468,239,411,421,56
PLK,8,2019,3180,1818,1362,713,1115,1357,140
PLK,8,2019,749,450,299,161,699,557,35
PLK,8,2019,1299,761,538,216,489,352,62
PLK,8,2019,827,484,343,148,550,368,28
PLK,8,2019,970,517,453,171,1172,1354,27
KVK,8,2019,1075,585,490,281,540,444,28
KVK,8,2019,1885,1026,859,352,237,340,55
KVK,8,2019,2369,1305,1064,386,115,143,106
ULK,8,2019,3377,1919,1458,508,217,150,131
ULK,8,2019,4256,2490,1766,604,1424,1470,166
ULK,8,2019,2184,1313,871,411,192,205,78
ULK,8,2019,2748,1591,1157,402,425,406,115
ULK,8,2019,3793,2296,1497,552,360,270,145
ULK,8,2019,2471,1418,1053,447,279,506,103
ULK,8,2019,3540,1968,1572,464,427,489,116
LBK,8,2019,1758,1027,731,374,384,393,80
LBK,8,2019,1852,1063,789,280,176,259,73
LBK,8,2019,3947,2288,1659,623,1455,1399,150
LBK,8,2019,1459,815,644,244,463,498,81
HKK,8,2019,2840,1606,1234,470,633,942,182
HKK,8,2019,1022,568,454,200,465,196,46
HKK,8,2019,1856,1011,845,377,216,265,89
HKK,8,2019,698,431,267,165,816,478,36
HKK,8,2019,1797,1016,781,373,440,410,90
PAK,8,2019,1381,829,552,311,440,514,82
PAK,8,2019,2281,1347,934,510,3033,2409,113
PAK,8,2019,1551,867,684,304,511,412,73
PAK,8,2019,1664,936,728,397,453,504,92
VYS,8,2019,1436,881,555,272,130,227,63
VYS,8,2019,2113,1177,936,386,390,448,134
VYS,8,2019,706,406,300,188,730,670,38
VYS,8,2019,2299,1363,936,337,175,199,112
VYS,8,2019,2311,1252,1059,398,244,211,145
JHM,8,2019,1726,917,809,245,161,144,90
JHM,8,2019,10977,6120,4857,1382,1294,1293,435
JHM,8,2019,3777,2080,1697,642,1418,1329,171
JHM,8,2019,2122,1152,970,384,565,622,128
JHM,8,2019,4512,2354,2158,607,631,601,226
JHM,8,2019,1291,762,529,229,224,128,39
JHM,8,2019,3179,1787,1392,476,273,184,127
OLK,8,2019,905,465,440,185,62,69,37
OLK,8,2019,3735,2047,1688,769,492,662,190
OLK,8,2019,1461,844,617,303,499,387,46
OLK,8,2019,2726,1617,1109,444,388,303,97
OLK,8,2019,2530,1430,1100,452,192,184,141
ZLK,8,2019,1772,971,801,318,252,241,71
ZLK,8,2019,2115,1224,891,460,242,440,134
ZLK,8,2019,2639,1337,1302,481,690,379,139
ZLK,8,2019,2657,1444,1213,529,1074,1375,130
MSK,8,2019,2954,1702,1252,453,287,334,97
MSK,8,2019,3993,1973,2020,666,415,474,150
MSK,8,2019,11284,5391,5893,1117,272,273,331
MSK,8,2019,2891,1509,1382,485,645,551,95
MSK,8,2019,2836,1477,1359,469,318,414,125
MSK,8,2019,11826,6306,5520,1474,810,1208,426
PHA,9,2019,18515,9868,8647,3764,3288,2267,661
STC,9,2019,1114,584,530,350,367,260,66
STC,9,2019,1651,888,763,359,340,484,108
STC,9,2019,4005,2263,1742,684,558,1363,212
STC,9,2019,2444,1442,1002,609,463,584,188
STC,9,2019,1496,839,657,412,236,614,100
STC,9,2019,2266,1323,943,584,847,454,143
STC,9,2019,1576,881,695,358,1341,1283,71
STC,9,2019,2112,1124,988,494,727,687,118
STC,9,2019,1488,854,634,450,3164,2884,96
STC,9,2019,1571,838,733,410,1454,3122,72
STC,9,2019,2470,1255,1215,552,362,532,151
STC,9,2019,935,560,375,225,166,105,64
JHC,9,2019,2306,1278,1028,742,917,611,173
JHC,9,2019,1176,659,517,304,482,225,60
JHC,9,2019,825,477,348,294,184,189,58
JHC,9,2019,794,457,337,317,595,404,61
JHC,9,2019,626,328,298,196,143,327,55
JHC,9,2019,1236,699,537,280,370,501,79
JHC,9,2019,1738,967,771,424,382,581,132
PLK,9,2019,783,453,330,227,1143,359,62
PLK,9,2019,1160,658,502,365,284,365,93
PLK,9,2019,2948,1662,1286,654,1281,1337,163
PLK,9,2019,749,451,298,198,546,722,51
PLK,9,2019,1227,685,542,292,223,484,83
PLK,9,2019,800,460,340,196,522,369,49
PLK,9,2019,991,509,482,242,1828,1297,46
KVK,9,2019,1089,558,531,380,405,488,49
KVK,9,2019,1905,1010,895,535,243,484,116
KVK,9,2019,2342,1265,1077,519,83,112,154
ULK,9,2019,3354,1855,1499,766,200,314,212
ULK,9,2019,4333,2482,1851,873,1453,1162,289
ULK,9,2019,2146,1258,888,628,283,293,162
ULK,9,2019,2757,1566,1191,593,558,474,198
ULK,9,2019,3700,2182,1518,829,258,246,234
ULK,9,2019,2426,1392,1034,648,349,426,149
ULK,9,2019,3291,1813,1478,607,192,285,165
LBK,9,2019,1739,969,770,539,367,500,177
LBK,9,2019,1788,993,795,423,217,282,95
LBK,9,2019,3834,2205,1629,881,1492,1607,209
LBK,9,2019,1427,775,652,344,351,266,97
HKK,9,2019,2773,1539,1234,662,842,633,205
HKK,9,2019,1003,534,469,280,404,319,81
HKK,9,2019,1892,986,906,606,311,340,134
HKK,9,2019,694,407,287,260,422,754,71
HKK,9,2019,1857,987,870,547,485,314,165
PAK,9,2019,1364,749,615,495,331,359,131
PAK,9,2019,2283,1278,1005,715,2561,4393,164
PAK,9,2019,1467,767,700,435,494,1002,113
PAK,9,2019,1699,938,761,549,348,464,142
VYS,9,2019,1433,832,601,364,124,214,98
VYS,9,2019,2008,1074,934,500,390,503,171
VYS,9,2019,669,369,300,224,467,691,49
VYS,9,2019,2257,1287,970,522,138,94,183
VYS,9,2019,2215,1153,1062,486,229,364,171
JHM,9,2019,1806,920,886,495,151,232,132
JHM,9,2019,10512,5728,4784,1724,1468,1368,507
JHM,9,2019,3684,1948,1736,864,1572,2355,244
JHM,9,2019,2116,1140,976,605,470,590,212
JHM,9,2019,4414,2228,2186,829,459,621,299
JHM,9,2019,1312,742,570,344,105,143,86
JHM,9,2019,3169,1758,1411,717,329,265,216
OLK,9,2019,890,436,454,248,96,125,69
OLK,9,2019,3775,1940,1835,1187,620,863,284
OLK,9,2019,1426,820,606,435,417,441,88
OLK,9,2019,2762,1587,1175,640,580,669,192
OLK,9,2019,2526,1365,1161,715,137,262,188
ZLK,9,2019,1775,960,815,484,238,253,113
ZLK,9,2019,2128,1179,949,601,497,348,174
ZLK,9,2019,2668,1276,1392,690,616,900,241
ZLK,9,2019,2601,1362,1239,710,1089,923,193
MSK,9,2019,2893,1632,1261,561,184,252,166
MSK,9,2019,4058,1900,2158,1056,457,596,298
MSK,9,2019,11267,5338,5929,1577,324,298,462
MSK,9,2019,2904,1484,1420,735,587,683,163
MSK,9,2019,2827,1437,1390,711,503,636,204
MSK,9,2019,11647,6147,5500,2003,1534,1237,562
PHA,10,2019,17985,9553,8432,3431,4180,7676,634
STC,10,2019,1069,567,502,264,206,395,55
STC,10,2019,1590,841,749,267,439,451,102
STC,10,2019,3842,2154,1688,566,409,586,185
STC,10,2019,2315,1339,976,439,812,467,173
STC,10,2019,1439,795,644,289,401,283,100
STC,10,2019,2227,1295,932,456,453,522,145
STC,10,2019,1496,837,659,260,755,952,72
STC,10,2019,2107,1143,964,463,694,770,128
STC,10,2019,1440,817,623,360,2262,1983,100
STC,10,2019,1516,811,705,313,1311,652,66
STC,10,2019,2425,1207,1218,449,501,481,130
STC,10,2019,900,529,371,193,138,221,63
JHC,10,2019,2246,1225,1021,642,569,693,155
JHC,10,2019,1204,671,533,312,298,223,60
JHC,10,2019,834,479,355,245,366,149,55
JHC,10,2019,774,459,315,235,450,496,56
JHC,10,2019,622,316,306,175,285,468,44
JHC,10,2019,1219,682,537,257,256,466,65
JHC,10,2019,1693,936,757,360,351,289,115
PLK,10,2019,784,440,344,185,1104,1638,66
PLK,10,2019,1103,628,475,295,316,472,78
PLK,10,2019,2971,1629,1342,802,749,744,164
PLK,10,2019,740,428,312,185,913,773,54
PLK,10,2019,1229,667,562,290,229,153,83
PLK,10,2019,784,458,326,148,533,347,43
PLK,10,2019,942,469,473,188,1010,2842,43
KVK,10,2019,1106,572,534,327,330,420,68
KVK,10,2019,1945,1011,934,474,238,307,122
KVK,10,2019,2338,1251,1087,531,176,247,163
ULK,10,2019,3359,1837,1522,636,185,373,196
ULK,10,2019,4180,2395,1785,699,1119,1624,246
ULK,10,2019,2074,1209,865,484,279,236,131
ULK,10,2019,2621,1486,1135,460,440,385,194
ULK,10,2019,3552,2086,1466,642,225,235,212
ULK,10,2019,2324,1300,1024,543,321,268,148
ULK,10,2019,3274,1811,1463,639,193,197,175
LBK,10,2019,1690,937,753,423,343,336,159
LBK,10,2019,1753,963,790,359,202,242,101
LBK,10,2019,3748,2118,1630,782,1501,1243,201
LBK,10,2019,1373,749,624,272,441,368,95
HKK,10,2019,2726,1446,1280,535,574,679,195
HKK,10,2019,941,506,435,211,386,339,78
HKK,10,2019,1915,962,953,418,211,222,127
HKK,10,2019,688,394,294,191,408,426,62
HKK,10,2019,1830,986,844,385,412,476,157
PAK,10,2019,1326,717,609,377,260,262,122
PAK,10,2019,2230,1243,987,563,1879,2594,153
PAK,10,2019,1408,730,678,338,440,393,91
PAK,10,2019,1636,906,730,410,350,442,128
VYS,10,2019,1375,788,587,248,111,163,83
VYS,10,2019,1860,999,861,360,428,517,139
VYS,10,2019,633,353,280,178,493,369,43
VYS,10,2019,2214,1270,944,417,139,231,174
VYS,10,2019,2121,1093,1028,383,194,233,138
JHM,10,2019,1754,893,861,304,106,130,122
JHM,10,2019,10222,5525,4697,1419,1281,798,466
JHM,10,2019,3527,1871,1656,632,1445,1097,220
JHM,10,2019,2065,1088,977,406,381,550,186
JHM,10,2019,4270,2153,2117,648,582,648,272
JHM,10,2019,1235,693,542,252,119,147,72
JHM,10,2019,3155,1769,1386,587,163,264,195
OLK,10,2019,896,460,436,253,51,80,55
OLK,10,2019,3652,1890,1762,901,452,489,243
OLK,10,2019,1358,783,575,344,306,305,71
OLK,10,2019,2622,1497,1125,496,506,369,157
OLK,10,2019,2453,1345,1108,518,214,206,167
ZLK,10,2019,1676,897,779,370,193,230,101
ZLK,10,2019,2037,1135,902,432,392,628,139
ZLK,10,2019,2523,1214,1309,487,429,566,187
ZLK,10,2019,2524,1305,1219,572,876,1334,155
MSK,10,2019,2871,1590,1281,495,254,184,141
MSK,10,2019,3869,1768,2101,707,362,503,232
MSK,10,2019,11035,5213,5822,1267,298,280,420
MSK,10,2019,2721,1390,1331,527,540,787,131
MSK,10,2019,2784,1386,1398,580,453,502,177
MSK,10,2019,11533,6035,5498,1722,921,1377,550
PHA,11,2019,17666,9272,8394,3206,4582,2091,575
STC,11,2019,1033,548,485,231,299,255,47
STC,11,2019,1611,835,776,293,614,409,87
STC,11,2019,3802,2122,1680,543,314,212,163
STC,11,2019,2300,1287,1013,445,545,237,147
STC,11,2019,1447,793,654,287,173,276,97
STC,11,2019,2191,1280,911,398,425,392,129
STC,11,2019,1478,839,639,266,1103,1054,70
STC,11,2019,2076,1094,982,323,816,657,111
STC,11,2019,1382,774,608,307,2255,2173,69
STC,11,2019,1488,789,699,289,939,1551,52
STC,11,2019,2402,1193,1209,449,365,257,111
STC,11,2019,879,509,370,182,239,120,42
JHC,11,2019,2221,1205,1016,607,612,711,126
JHC,11,2019,1343,740,603,340,305,372,62
JHC,11,2019,901,532,369,282,190,145,45
JHC,11,2019,831,492,339,261,327,362,40
JHC,11,2019,692,349,343,227,153,209,44
JHC,11,2019,1217,687,530,270,247,290,63
JHC,11,2019,1681,919,762,336,342,454,106
PLK,11,2019,793,438,355,191,1049,1528,72
PLK,11,2019,1231,713,518,401,478,314,71
PLK,11,2019,2930,1591,1339,616,1194,1182,149
PLK,11,2019,773,441,332,175,687,599,42
PLK,11,2019,1273,674,599,284,490,164,80
PLK,11,2019,779,450,329,136,277,319,34
PLK,11,2019,953,464,489,193,1205,1058,47
KVK,11,2019,1108,563,545,315,413,337,57
KVK,11,2019,1968,1033,935,430,280,248,97
KVK,11,2019,2296,1212,1084,440,70,94,152
ULK,11,2019,3481,1926,1555,696,203,553,181
ULK,11,2019,4099,2346,1753,616,1504,1876,221
ULK,11,2019,2109,1190,919,500,214,287,116
ULK,11,2019,2591,1472,1119,406,336,459,163
ULK,11,2019,3490,2024,1466,623,192,253,182
ULK,11,2019,2338,1308,1030,539,244,380,134
ULK,11,2019,3262,1772,1490,585,181,191,164
LBK,11,2019,1716,959,757,410,492,410,139
LBK,11,2019,1704,939,765,297,229,186,78
LBK,11,2019,3773,2062,1711,823,1494,1637,175
LBK,11,2019,1411,736,675,293,465,595,92
HKK,11,2019,2666,1406,1260,516,502,855,161
HKK,11,2019,909,474,435,217,568,262,64
HKK,11,2019,2037,979,1058,458,213,196,113
HKK,11,2019,669,380,289,190,528,352,38
HKK,11,2019,1890,993,897,399,287,327,132
PAK,11,2019,1396,728,668,393,250,284,109
PAK,11,2019,2291,1267,1024,597,2393,1907,140
PAK,11,2019,1481,746,735,379,266,223,79
PAK,11,2019,1591,866,725,388,435,541,92
VYS,11,2019,1418,817,601,297,159,176,73
VYS,11,2019,1863,1002,861,393,327,310,120
VYS,11,2019,640,338,302,202,536,518,39
VYS,11,2019,2287,1256,1031,491,143,98,150
VYS,11,2019,2093,1052,1041,356,336,297,121
JHM,11,2019,1767,878,889,318,178,183,103
JHM,11,2019,9994,5410,4584,1301,1480,1365,431
JHM,11,2019,3493,1821,1672,644,1277,1339,191
JHM,11,2019,2253,1197,1056,586,486,339,174
JHM,11,2019,4418,2157,2261,737,568,715,258
JHM,11,2019,1235,663,572,231,158,116,64
JHM,11,2019,3372,1868,1504,737,173,122,176
OLK,11,2019,972,507,465,257,103,48,40
OLK,11,2019,3670,1866,1804,885,583,589,224
OLK,11,2019,1372,801,571,340,229,190,79
OLK,11,2019,2632,1504,1128,489,409,414,138
OLK,11,2019,2482,1319,1163,568,222,256,147
ZLK,11,2019,1717,903,814,410,223,275,86
ZLK,11,2019,2069,1127,942,420,329,414,132
ZLK,11,2019,2568,1206,1362,581,459,1092,163
ZLK,11,2019,2507,1270,1237,541,924,1155,129
MSK,11,2019,2963,1593,1370,519,143,166,127
MSK,11,2019,3854,1716,2138,745,466,495,168
MSK,11,2019,10993,5128,5865,1209,308,298,398
MSK,11,2019,2773,1363,1410,563,486,607,122
MSK,11,2019,2801,1375,1426,534,438,372,153
MSK,11,2019,11434,5945,5489,1484,875,992,496
PHA,12,2019,17955,9402,8553,2737,4890,4707,531
STC,12,2019,1140,569,571,294,224,252,42
STC,12,2019,1709,855,854,302,288,104,79
STC,12,2019,3902,2143,1759,482,314,170,153
STC,12,2019,2466,1314,1152,462,367,266,150
STC,12,2019,1638,846,792,394,137,121,97
STC,12,2019,2337,1346,991,443,431,236,128
STC,12,2019,1530,852,678,245,1003,414,55
STC,12,2019,2212,1129,1083,405,421,352,111
STC,12,2019,1423,805,618,299,1975,1519,60
STC,12,2019,1535,788,747,260,647,599,48
STC,12,2019,2718,1260,1458,635,389,300,112
STC,12,2019,982,549,433,212,153,167,45
JHC,12,2019,2455,1243,1212,662,327,678,116
JHC,12,2019,1561,754,807,408,320,383,62
JHC,12,2019,1215,607,608,460,156,246,49
JHC,12,2019,987,534,453,310,425,385,40
JHC,12,2019,950,395,555,347,104,225,47
JHC,12,2019,1438,738,700,369,204,257,64
JHC,12,2019,1931,953,978,478,164,165,110
PLK,12,2019,911,465,446,223,591,521,69
PLK,12,2019,1515,745,770,502,303,273,61
PLK,12,2019,3153,1677,1476,667,869,967,147
PLK,12,2019,863,473,390,197,704,272,41
PLK,12,2019,1410,712,698,291,298,242,77
PLK,12,2019,854,479,375,163,397,448,35
PLK,12,2019,1105,494,611,284,788,773,51
KVK,12,2019,1263,617,646,352,309,424,54
KVK,12,2019,2120,1099,1021,455,177,339,95
KVK,12,2019,2416,1249,1167,407,40,77,137
ULK,12,2019,3690,1945,1745,644,160,145,182
ULK,12,2019,4252,2390,1862,606,1561,943,213
ULK,12,2019,2434,1329,1105,654,138,170,112
ULK,12,2019,2759,1501,1258,458,203,227,153
ULK,12,2019,3646,2125,1521,665,300,272,183
ULK,12,2019,2445,1358,1087,471,210,258,126
ULK,12,2019,3411,1829,1582,562,126,147,163
LBK,12,2019,1894,1025,869,471,219,175,100
LBK,12,2019,1802,980,822,337,192,260,76
LBK,12,2019,4017,2100,1917,729,1177,896,163
LBK,12,2019,1628,779,849,378,310,366,87
HKK,12,2019,2947,1457,1490,629,606,576,171
HKK,12,2019,1025,502,523,269,334,164,67
HKK,12,2019,2358,1039,1319,575,125,217,113
HKK,12,2019,727,406,321,185,337,271,37
HKK,12,2019,2019,993,1026,444,314,336,122
PAK,12,2019,1752,779,973,586,509,494,101
PAK,12,2019,2495,1350,1145,568,2236,1515,142
PAK,12,2019,1914,864,1050,619,243,239,86
PAK,12,2019,1769,898,871,456,263,340,81
VYS,12,2019,1609,856,753,363,128,193,77
VYS,12,2019,2187,1028,1159,578,392,214,117
VYS,12,2019,746,356,390,235,435,367,37
VYS,12,2019,2683,1332,1351,676,117,99,145
VYS,12,2019,2417,1072,1345,586,98,211,113
JHM,12,2019,1948,931,1017,362,65,101,110
JHM,12,2019,10235,5477,4758,1220,1106,1291,429
JHM,12,2019,3735,1871,1864,694,1453,1281,182
JHM,12,2019,2751,1325,1426,787,273,398,169
JHM,12,2019,5145,2342,2803,1121,393,271,241
JHM,12,2019,1321,666,655,251,126,98,66
JHM,12,2019,3952,1980,1972,958,98,116,170
OLK,12,2019,1318,604,714,471,43,58,46
OLK,12,2019,4192,1962,2230,1113,408,695,213
OLK,12,2019,1499,860,639,334,150,249,67
OLK,12,2019,3017,1607,1410,712,279,447,149
OLK,12,2019,2792,1326,1466,694,152,258,147
ZLK,12,2019,1937,947,990,456,175,171,78
ZLK,12,2019,2332,1166,1166,560,215,228,123
ZLK,12,2019,3001,1293,1708,769,485,363,154
ZLK,12,2019,2730,1318,1412,607,794,863,121
MSK,12,2019,3538,1688,1850,833,123,138,135
MSK,12,2019,4254,1834,2420,875,275,373,157
MSK,12,2019,11434,5286,6148,1237,229,258,384
MSK,12,2019,3099,1424,1675,665,526,670,119
MSK,12,2019,3195,1407,1788,769,322,338,144
MSK,12,2019,11787,6019,5768,1438,1050,959,492
PHA,1,2020,18390,9566,8824,4108,4985,5903,501
STC,1,2020,1212,585,627,340,214,200,36
STC,1,2020,1788,872,916,378,411,473,74
STC,1,2020,4153,2210,1943,775,491,698,145
STC,1,2020,2593,1328,1265,607,982,959,139
STC,1,2020,1737,859,878,383,414,419,95
STC,1,2020,2452,1369,1083,555,794,601,124
STC,1,2020,1580,857,723,347,1273,1458,59
STC,1,2020,2279,1131,1148,452,1001,875,105
STC,1,2020,1526,820,706,430,2796,2434,61
STC,1,2020,1586,827,759,383,1091,568,37
STC,1,2020,2967,1318,1649,683,619,479,120
STC,1,2020,1050,556,494,251,265,237,45
JHC,1,2020,2677,1246,1431,910,600,571,119
JHC,1,2020,1820,805,1015,525,276,85,65
JHC,1,2020,1491,663,828,512,294,297,56
JHC,1,2020,1185,587,598,449,398,529,46
JHC,1,2020,1028,399,629,310,458,239,44
JHC,1,2020,1666,761,905,483,374,293,58
JHC,1,2020,2176,1008,1168,617,527,439,91
PLK,1,2020,1014,500,514,303,1132,1137,58
PLK,1,2020,1631,722,909,472,444,361,57
PLK,1,2020,3541,1767,1774,1073,1199,1065,140
PLK,1,2020,913,460,453,249,503,759,32
PLK,1,2020,1579,762,817,414,372,287,71
PLK,1,2020,934,512,422,224,360,397,36
PLK,1,2020,1178,510,668,305,1278,627,57
KVK,1,2020,1435,669,766,464,477,557,55
KVK,1,2020,2320,1129,1191,609,261,661,83
KVK,1,2020,2583,1297,1286,678,88,76,129
ULK,1,2020,4117,2131,1986,1026,196,276,174
ULK,1,2020,4663,2585,2078,1019,1536,1719,230
ULK,1,2020,2583,1371,1212,637,339,440,104
ULK,1,2020,3083,1656,1427,711,349,542,147
ULK,1,2020,3945,2269,1676,858,247,212,177
ULK,1,2020,2695,1443,1252,783,397,686,130
ULK,1,2020,3631,1908,1723,734,237,350,165
LBK,1,2020,2001,1078,923,499,405,481,97
LBK,1,2020,1889,976,913,461,194,205,82
LBK,1,2020,4154,2124,2030,925,1630,1804,163
LBK,1,2020,1757,780,977,443,432,460,81
HKK,1,2020,3094,1471,1623,753,883,438,161
HKK,1,2020,1154,530,624,362,389,429,67
HKK,1,2020,2478,1102,1376,586,298,364,111
HKK,1,2020,814,430,384,272,530,730,43
HKK,1,2020,2144,1017,1127,534,343,422,128
PAK,1,2020,2002,850,1152,636,355,325,103
PAK,1,2020,2610,1372,1238,687,3561,3074,134
PAK,1,2020,2078,890,1188,526,400,630,77
PAK,1,2020,1932,944,988,595,451,543,80
VYS,1,2020,1682,874,808,358,205,126,69
VYS,1,2020,2324,1038,1286,550,563,412,116
VYS,1,2020,782,369,413,245,642,513,34
VYS,1,2020,2862,1383,1479,645,178,130,130
VYS,1,2020,2560,1077,1483,561,238,248,115
JHM,1,2020,2036,942,1094,403,143,132,105
JHM,1,2020,10538,5548,4990,1870,1551,1274,383
JHM,1,2020,3994,1953,2041,939,1953,2133,174
JHM,1,2020,2959,1364,1595,657,407,319,164
JHM,1,2020,5527,2394,3133,1089,770,763,239
JHM,1,2020,1436,715,721,383,162,195,66
JHM,1,2020,4526,2077,2449,1171,399,329,182
OLK,1,2020,1454,614,840,332,72,64,46
OLK,1,2020,4548,2034,2514,1278,590,483,219
OLK,1,2020,1708,952,756,542,204,331,78
OLK,1,2020,3261,1657,1604,763,574,469,161
OLK,1,2020,2999,1325,1674,683,189,258,142
ZLK,1,2020,2048,965,1083,502,326,490,79
ZLK,1,2020,2496,1206,1290,574,336,547,125
ZLK,1,2020,3166,1304,1862,700,676,330,146
ZLK,1,2020,2912,1388,1524,754,1042,996,109
MSK,1,2020,3759,1719,2040,768,185,237,150
MSK,1,2020,4545,1889,2656,1059,423,368,140
MSK,1,2020,11834,5414,6420,1671,216,283,367
MSK,1,2020,3163,1408,1755,685,708,585,104
MSK,1,2020,3355,1420,1935,755,611,677,146
MSK,1,2020,12240,6126,6114,2047,1011,983,486
PHA,2,2020,18423,9434,8989,3292,5790,2654,482
STC,2,2020,1175,572,603,217,266,219,34
STC,2,2020,1745,854,891,243,518,254,78
STC,2,2020,4139,2184,1955,512,768,503,141
STC,2,2020,2508,1293,1215,359,637,517,139
STC,2,2020,1713,836,877,276,621,442,98
STC,2,2020,2387,1306,1081,354,786,537,120
STC,2,2020,1549,832,717,246,1073,1022,48
STC,2,2020,2287,1138,1149,374,1112,968,102
STC,2,2020,1487,798,689,293,3180,732,64
STC,2,2020,1615,844,771,321,1663,979,48
STC,2,2020,2937,1314,1623,408,670,324,117
STC,2,2020,1024,544,480,157,194,235,49
JHC,2,2020,2613,1219,1394,556,699,663,129
JHC,2,2020,1745,787,958,225,441,738,68
JHC,2,2020,1472,656,816,228,290,319,56
JHC,2,2020,1161,587,574,201,486,367,47
JHC,2,2020,981,392,589,158,304,235,40
JHC,2,2020,1668,766,902,226,383,228,61
JHC,2,2020,2119,985,1134,304,297,507,101
PLK,2,2020,991,499,492,179,1326,1273,60
PLK,2,2020,1636,737,899,276,557,479,60
PLK,2,2020,3517,1724,1793,706,1377,625,140
PLK,2,2020,918,448,470,173,447,593,41
PLK,2,2020,1530,718,812,212,462,378,67
PLK,2,2020,929,510,419,139,333,314,38
PLK,2,2020,1168,504,664,217,1144,683,51
KVK,2,2020,1391,645,746,287,482,676,53
KVK,2,2020,2290,1118,1172,381,330,371,78
KVK,2,2020,2565,1274,1291,443,87,119,128
ULK,2,2020,4052,2094,1958,559,166,236,174
ULK,2,2020,4613,2526,2087,594,1696,1278,223
ULK,2,2020,2642,1394,1248,457,213,252,104
ULK,2,2020,3115,1651,1464,401,423,167,149
ULK,2,2020,3872,2227,1645,559,269,271,165
ULK,2,2020,2831,1496,1335,561,655,337,139
ULK,2,2020,3580,1857,1723,473,277,195,161
LBK,2,2020,2024,1077,947,373,349,399,100
LBK,2,2020,1875,954,921,315,184,242,88
LBK,2,2020,4148,2115,2033,684,1530,1714,167
LBK,2,2020,1706,734,972,220,506,434,80
HKK,2,2020,2992,1424,1568,457,1018,756,172
HKK,2,2020,1144,542,602,209,389,689,68
HKK,2,2020,2505,1127,1378,392,210,233,110
HKK,2,2020,836,429,407,190,543,548,46
HKK,2,2020,2096,996,1100,324,317,400,116
PAK,2,2020,1910,836,1074,295,458,412,95
PAK,2,2020,2579,1338,1241,503,2917,2444,129
PAK,2,2020,2055,887,1168,321,377,455,72
PAK,2,2020,1897,932,965,349,433,497,88
VYS,2,2020,1597,842,755,232,207,218,72
VYS,2,2020,2278,1041,1237,362,436,593,109
VYS,2,2020,773,374,399,176,525,610,33
VYS,2,2020,2861,1404,1457,413,110,240,136
VYS,2,2020,2472,1050,1422,291,209,214,133
JHM,2,2020,2016,943,1073,266,199,187,111
JHM,2,2020,10415,5469,4946,1255,1366,681,366
JHM,2,2020,3924,1898,2026,563,1835,2310,197
JHM,2,2020,2888,1323,1565,396,463,547,151
JHM,2,2020,5403,2346,3057,565,514,393,236
JHM,2,2020,1422,711,711,218,165,143,65
JHM,2,2020,4491,2027,2464,522,308,245,188
OLK,2,2020,1496,627,869,205,108,81,46
OLK,2,2020,4440,2003,2437,747,596,459,217
OLK,2,2020,1664,934,730,307,220,141,79
OLK,2,2020,3273,1670,1603,471,403,391,146
OLK,2,2020,2908,1326,1582,419,218,184,128
ZLK,2,2020,1998,920,1078,328,317,204,73
ZLK,2,2020,2368,1144,1224,382,620,357,120
ZLK,2,2020,3112,1267,1845,455,463,349,121
ZLK,2,2020,2810,1323,1487,504,993,910,105
MSK,2,2020,3710,1703,2007,382,214,454,162
MSK,2,2020,4475,1842,2633,626,419,479,126
MSK,2,2020,11786,5318,6468,1070,242,384,357
MSK,2,2020,3102,1353,1749,477,602,554,96
MSK,2,2020,3312,1404,1908,474,414,537,146
MSK,2,2020,12220,6103,6117,1369,1096,904,486
PHA,3,2020,18788,9659,9129,3218,3299,3171,448
STC,3,2020,1221,609,612,276,284,63,33
STC,3,2020,1756,858,898,305,343,544,84
STC,3,2020,4119,2171,1948,460,174,52,135
STC,3,2020,2482,1313,1169,448,350,620,126
STC,3,2020,1696,837,859,310,151,244,86
STC,3,2020,2416,1333,1083,409,214,413,120
STC,3,2020,1476,801,675,224,682,838,51
STC,3,2020,2259,1152,1107,360,480,486,106
STC,3,2020,1608,883,725,444,1411,1444,64
STC,3,2020,1697,868,829,320,927,580,46
STC,3,2020,2833,1310,1523,455,266,325,101
STC,3,2020,1039,567,472,213,164,185,48
JHC,3,2020,2526,1236,1290,575,418,731,127
JHC,3,2020,1776,855,921,340,155,404,61
JHC,3,2020,1148,598,550,141,177,245,49
JHC,3,2020,1123,613,510,279,188,528,51
JHC,3,2020,914,394,520,156,111,261,35
JHC,3,2020,1486,734,752,188,163,336,53
JHC,3,2020,1985,965,1020,291,235,309,94
PLK,3,2020,1020,547,473,232,786,132,61
PLK,3,2020,1613,793,820,367,175,496,60
PLK,3,2020,3688,1843,1845,825,567,1333,151
PLK,3,2020,876,450,426,154,343,386,42
PLK,3,2020,1502,731,771,245,252,249,63
PLK,3,2020,927,502,425,161,234,250,34
PLK,3,2020,1188,529,659,261,768,3641,54
KVK,3,2020,1505,717,788,342,358,578,55
KVK,3,2020,2400,1188,1212,483,222,348,80
KVK,3,2020,2576,1301,1275,408,69,82,116
ULK,3,2020,4021,2096,1925,532,173,174,172
ULK,3,2020,4558,2492,2066,563,1077,991,219
ULK,3,2020,2645,1415,1230,448,411,290,100
ULK,3,2020,3045,1650,1395,346,560,427,138
ULK,3,2020,3846,2231,1615,535,111,297,158
ULK,3,2020,2828,1519,1309,394,211,178,121
ULK,3,2020,3597,1858,1739,479,170,200,161
LBK,3,2020,1994,1086,908,354,338,381,99
LBK,3,2020,1931,999,932,324,130,121,104
LBK,3,2020,4147,2120,2027,617,701,1180,168
LBK,3,2020,1719,782,937,263,265,436,85
HKK,3,2020,2892,1455,1437,455,714,741,159
HKK,3,2020,1164,557,607,259,188,512,66
HKK,3,2020,2480,1170,1310,411,182,294,108
HKK,3,2020,838,446,392,180,356,482,40
HKK,3,2020,2092,1029,1063,371,220,430,103
PAK,3,2020,1789,868,921,412,197,330,100
PAK,3,2020,2483,1302,1181,441,1454,1317,120
PAK,3,2020,1976,891,1085,331,231,177,74
PAK,3,2020,1869,960,909,368,297,422,82
VYS,3,2020,1574,867,707,299,108,66,66
VYS,3,2020,2152,1039,1113,385,623,541,119
VYS,3,2020,764,377,387,172,224,528,30
VYS,3,2020,2795,1459,1336,435,83,68,134
VYS,3,2020,2371,1059,1312,354,127,200,129
JHM,3,2020,2001,945,1056,290,101,120,118
JHM,3,2020,10553,5553,5000,1401,1232,1343,394
JHM,3,2020,3977,1949,2028,695,668,1370,209
JHM,3,2020,2878,1353,1525,585,263,505,154
JHM,3,2020,5199,2390,2809,634,272,335,229
JHM,3,2020,1440,737,703,292,117,253,66
JHM,3,2020,4056,1930,2126,447,123,130,178
OLK,3,2020,1446,645,801,225,34,88,49
OLK,3,2020,4306,2002,2304,753,466,387,220
OLK,3,2020,1676,951,725,291,118,281,77
OLK,3,2020,3122,1637,1485,381,170,313,138
OLK,3,2020,2861,1369,1492,461,161,154,128
ZLK,3,2020,1978,967,1011,368,168,227,79
ZLK,3,2020,2367,1187,1180,489,224,175,121
ZLK,3,2020,3128,1345,1783,536,429,531,129
ZLK,3,2020,2924,1379,1545,582,715,600,102
MSK,3,2020,3527,1678,1849,379,144,170,161
MSK,3,2020,4464,1888,2576,726,262,409,152
MSK,3,2020,11909,5392,6517,1055,148,309,344
MSK,3,2020,3190,1454,1736,620,229,590,91
MSK,3,2020,3218,1417,1801,511,379,213,128
MSK,3,2020,12245,6168,6077,1375,782,1099,485
PHA,4,2020,22421,11434,10987,5385,2029,601,510
STC,4,2020,1534,781,753,497,104,43,37
STC,4,2020,2000,983,1017,403,194,171,96
STC,4,2020,4534,2388,2146,721,475,58,146
STC,4,2020,2750,1447,1303,515,496,228,137
STC,4,2020,1736,898,838,287,212,289,89
STC,4,2020,2799,1506,1293,605,514,385,130
STC,4,2020,1695,907,788,361,196,495,58
STC,4,2020,2571,1290,1281,544,480,380,118
STC,4,2020,2189,1171,1018,756,848,4147,76
STC,4,2020,2141,1076,1065,618,158,1064,54
STC,4,2020,3114,1461,1653,624,84,114,122
STC,4,2020,1167,634,533,249,69,121,61
JHC,4,2020,3179,1550,1629,1063,323,394,150
JHC,4,2020,2117,1045,1072,661,66,38,66
JHC,4,2020,1442,768,674,560,88,209,57
JHC,4,2020,1332,697,635,352,89,145,71
JHC,4,2020,957,398,559,217,224,188,34
JHC,4,2020,1601,823,778,328,89,210,65
JHC,4,2020,2259,1108,1151,564,146,331,110
PLK,4,2020,1264,655,609,344,440,93,60
PLK,4,2020,1745,890,855,429,173,171,65
PLK,4,2020,4305,2151,2154,952,305,822,167
PLK,4,2020,987,503,484,230,272,637,46
PLK,4,2020,1659,816,843,375,110,284,74
PLK,4,2020,1039,558,481,205,61,128,39
PLK,4,2020,1336,607,729,339,186,981,54
KVK,4,2020,2303,1130,1173,974,220,250,62
KVK,4,2020,3242,1621,1621,1109,124,463,102
KVK,4,2020,3046,1521,1525,693,51,87,129
ULK,4,2020,4379,2291,2088,726,102,121,181
ULK,4,2020,5079,2746,2333,843,295,201,227
ULK,4,2020,2784,1502,1282,555,149,217,114
ULK,4,2020,3066,1673,1393,388,131,350,143
ULK,4,2020,4297,2457,1840,701,79,40,166
ULK,4,2020,3340,1797,1543,761,77,224,127
ULK,4,2020,4006,2061,1945,632,113,246,171
LBK,4,2020,2305,1230,1075,531,110,135,114
LBK,4,2020,2263,1162,1101,513,45,89,109
LBK,4,2020,4559,2339,2220,856,281,613,178
LBK,4,2020,1800,854,946,332,84,112,85
HKK,4,2020,3124,1591,1533,558,456,575,192
HKK,4,2020,1379,645,734,368,211,717,73
HKK,4,2020,2677,1302,1375,558,105,162,111
HKK,4,2020,938,505,433,231,84,495,48
HKK,4,2020,2414,1199,1215,578,146,176,130
PAK,4,2020,1906,949,957,410,89,86,116
PAK,4,2020,2933,1555,1378,773,525,1701,155
PAK,4,2020,1977,925,1052,377,170,178,82
PAK,4,2020,2180,1120,1060,602,175,266,102
VYS,4,2020,1794,1001,793,432,85,105,78
VYS,4,2020,2377,1208,1169,567,162,393,146
VYS,4,2020,981,481,500,357,75,118,39
VYS,4,2020,2955,1578,1377,554,57,64,161
VYS,4,2020,2495,1163,1332,513,69,105,144
JHM,4,2020,2298,1065,1233,506,117,115,127
JHM,4,2020,11769,6161,5608,1981,1113,546,444
JHM,4,2020,4425,2185,2240,899,351,815,225
JHM,4,2020,3191,1537,1654,725,150,292,189
JHM,4,2020,5496,2590,2906,795,394,501,265
JHM,4,2020,1651,846,805,372,82,30,74
JHM,4,2020,4602,2302,2300,1019,79,104,216
OLK,4,2020,1470,684,786,281,43,46,61
OLK,4,2020,4831,2350,2481,1076,267,731,255
OLK,4,2020,1995,1086,909,472,65,389,83
OLK,4,2020,3395,1815,1580,595,80,190,158
OLK,4,2020,3099,1537,1562,605,123,127,140
ZLK,4,2020,2261,1121,1140,496,164,295,97
ZLK,4,2020,2638,1318,1320,572,246,402,131
ZLK,4,2020,3430,1530,1900,702,200,243,149
ZLK,4,2020,3366,1668,1698,803,735,485,140
MSK,4,2020,3614,1807,1807,538,119,60,170
MSK,4,2020,4831,2160,2671,951,135,241,176
MSK,4,2020,12692,5795,6897,1505,144,129,359
MSK,4,2020,3676,1713,1963,867,241,293,115
MSK,4,2020,3525,1579,1946,741,268,203,138
MSK,4,2020,13313,6695,6618,1818,336,439,494
PHA,5,2020,25424,12802,12622,4916,2921,858,524
STC,5,2020,1586,804,782,253,161,143,40
STC,5,2020,2138,1046,1092,314,241,80,88
STC,5,2020,4903,2535,2368,692,349,792,159
STC,5,2020,2823,1502,1321,387,991,259,135
STC,5,2020,1725,897,828,207,445,167,83
STC,5,2020,2909,1547,1362,425,707,245,125
STC,5,2020,1941,1015,926,418,465,448,67
STC,5,2020,2621,1344,1277,328,785,567,114
STC,5,2020,2369,1260,1109,409,1363,2194,80
STC,5,2020,2292,1163,1129,352,422,641,54
STC,5,2020,3125,1475,1650,376,388,169,107
STC,5,2020,1195,650,545,152,85,81,48
JHC,5,2020,3269,1624,1645,501,464,375,141
JHC,5,2020,2100,1073,1027,328,263,276,72
JHC,5,2020,1455,797,658,237,177,145,61
JHC,5,2020,1336,705,631,218,196,355,72
JHC,5,2020,955,428,527,146,146,106,36
JHC,5,2020,1597,828,769,206,320,142,73
JHC,5,2020,2254,1139,1115,307,228,225,108
PLK,5,2020,1365,719,646,238,593,2412,63
PLK,5,2020,1717,880,837,240,296,248,57
PLK,5,2020,4758,2352,2406,850,614,1617,156
PLK,5,2020,1034,522,512,147,324,547,38
PLK,5,2020,1725,848,877,257,188,400,68
PLK,5,2020,1104,574,530,147,57,345,38
PLK,5,2020,1439,658,781,244,355,1196,47
KVK,5,2020,2697,1343,1354,629,156,151,74
KVK,5,2020,3723,1911,1812,707,196,422,113
KVK,5,2020,3408,1694,1714,628,92,79,129
ULK,5,2020,4551,2385,2166,583,144,135,169
ULK,5,2020,5457,2927,2530,707,944,1121,229
ULK,5,2020,2783,1501,1282,375,185,258,94
ULK,5,2020,3182,1722,1460,387,652,757,141
ULK,5,2020,4660,2589,2071,641,192,176,165
ULK,5,2020,3653,1935,1718,609,517,386,142
ULK,5,2020,4118,2113,2005,476,236,222,152
LBK,5,2020,2544,1328,1216,476,153,364,106
LBK,5,2020,2413,1226,1187,346,108,116,99
LBK,5,2020,4912,2502,2410,725,648,581,187
LBK,5,2020,1794,871,923,238,498,187,79
HKK,5,2020,3254,1661,1593,470,663,374,189
HKK,5,2020,1422,657,765,221,280,196,73
HKK,5,2020,2703,1336,1367,368,239,248,109
HKK,5,2020,979,515,464,166,146,312,44
HKK,5,2020,2497,1229,1268,379,267,146,137
PAK,5,2020,1869,962,907,279,366,285,110
PAK,5,2020,3141,1652,1489,589,1685,920,147
PAK,5,2020,1919,926,993,299,597,787,81
PAK,5,2020,2263,1169,1094,357,433,643,99
VYS,5,2020,1852,1047,805,274,112,104,68
VYS,5,2020,2413,1230,1183,327,202,208,144
VYS,5,2020,1089,517,572,254,251,438,42
VYS,5,2020,2887,1569,1318,308,150,74,147
VYS,5,2020,2548,1217,1331,361,204,98,123
JHM,5,2020,2398,1120,1278,343,99,99,117
JHM,5,2020,12340,6473,5867,1425,1245,742,445
JHM,5,2020,4533,2267,2266,599,761,943,216
JHM,5,2020,3133,1527,1606,428,362,230,171
JHM,5,2020,5428,2633,2795,515,675,400,229
JHM,5,2020,1683,853,830,213,136,63,70
JHM,5,2020,4616,2361,2255,838,267,164,206
OLK,5,2020,1381,673,708,143,65,73,53
OLK,5,2020,4954,2419,2535,751,549,470,238
OLK,5,2020,2111,1144,967,290,142,514,78
OLK,5,2020,3480,1860,1620,432,222,271,146
OLK,5,2020,3120,1564,1556,413,133,137,121
ZLK,5,2020,2281,1128,1153,304,191,208,100
ZLK,5,2020,2683,1367,1316,381,543,535,138
ZLK,5,2020,3445,1550,1895,445,293,1278,154
ZLK,5,2020,3430,1704,1726,503,476,501,141
MSK,5,2020,3667,1869,1798,439,225,333,153
MSK,5,2020,4968,2244,2724,622,265,253,157
MSK,5,2020,13092,5960,7132,1145,253,250,342
MSK,5,2020,3800,1776,2024,534,335,495,100
MSK,5,2020,3553,1613,1940,497,401,465,143
MSK,5,2020,14158,7115,7043,1651,667,618,483
PHA,6,2020,27405,13809,13596,4842,5452,2225,505
STC,6,2020,1543,793,750,262,338,215,25
STC,6,2020,2183,1061,1122,342,396,313,80
STC,6,2020,5074,2605,2469,678,619,327,139
STC,6,2020,2842,1515,1327,438,1620,1170,120
STC,6,2020,1684,886,798,264,341,283,67
STC,6,2020,2971,1587,1384,411,989,629,117
STC,6,2020,2097,1094,1003,412,755,714,63
STC,6,2020,2673,1356,1317,368,808,851,108
STC,6,2020,2473,1327,1146,425,2879,955,74
STC,6,2020,2391,1229,1162,353,1407,778,55
STC,6,2020,3109,1470,1639,406,1220,706,90
STC,6,2020,1158,635,523,153,75,177,49
JHC,6,2020,3248,1605,1643,543,552,551,134
JHC,6,2020,1921,957,964,230,682,542,57
JHC,6,2020,1382,749,633,258,184,207,61
JHC,6,2020,1295,683,612,239,570,402,57
JHC,6,2020,926,431,495,166,294,309,40
JHC,6,2020,1563,830,733,222,269,351,58
JHC,6,2020,2224,1131,1093,290,451,250,84
PLK,6,2020,1367,701,666,194,397,1594,58
PLK,6,2020,1606,813,793,262,695,762,51
PLK,6,2020,4864,2442,2422,728,1341,2697,133
PLK,6,2020,1052,545,507,160,444,603,43
PLK,6,2020,1721,855,866,243,242,344,56
PLK,6,2020,1119,579,540,133,163,876,37
PLK,6,2020,1442,666,776,233,729,1005,45
KVK,6,2020,2653,1346,1307,401,412,636,67
KVK,6,2020,3993,2033,1960,629,208,312,106
KVK,6,2020,3509,1729,1780,484,76,78,118
ULK,6,2020,4624,2375,2249,598,235,339,152
ULK,6,2020,5546,2940,2606,653,1405,661,198
ULK,6,2020,2760,1509,1251,409,293,175,90
ULK,6,2020,3289,1746,1543,475,694,610,121
ULK,6,2020,4823,2647,2176,595,202,466,160
ULK,6,2020,3837,2025,1812,548,248,355,138
ULK,6,2020,4312,2193,2119,565,323,177,146
LBK,6,2020,2653,1382,1271,483,310,530,116
LBK,6,2020,2445,1241,1204,363,286,283,102
LBK,6,2020,5067,2579,2488,764,1230,1510,163
LBK,6,2020,1777,885,892,246,549,872,72
HKK,6,2020,3340,1678,1662,582,824,1471,167
HKK,6,2020,1408,667,741,222,376,385,61
HKK,6,2020,2619,1274,1345,319,250,254,93
HKK,6,2020,957,500,457,176,480,398,33
HKK,6,2020,2466,1207,1259,372,381,486,110
PAK,6,2020,1838,946,892,319,458,372,79
PAK,6,2020,3149,1628,1521,523,3634,2952,131
PAK,6,2020,1851,898,953,282,1012,602,67
PAK,6,2020,2274,1147,1127,370,499,525,92
VYS,6,2020,1801,1013,788,240,140,194,55
VYS,6,2020,2426,1228,1198,410,624,464,112
VYS,6,2020,1040,504,536,212,408,401,30
VYS,6,2020,2825,1532,1293,344,245,85,120
VYS,6,2020,2496,1211,1285,307,289,387,90
JHM,6,2020,2378,1127,1251,261,160,174,101
JHM,6,2020,12572,6561,6011,1422,1752,856,419
JHM,6,2020,4553,2302,2251,613,1393,1190,178
JHM,6,2020,2857,1392,1465,347,605,394,140
JHM,6,2020,5202,2556,2646,523,870,667,191
JHM,6,2020,1655,836,819,205,145,287,69
JHM,6,2020,4280,2180,2100,609,492,271,166
OLK,6,2020,1338,630,708,170,171,116,42
OLK,6,2020,4980,2394,2586,803,528,615,210
OLK,6,2020,2073,1111,962,333,281,383,64
OLK,6,2020,3582,1930,1652,513,355,625,129
OLK,6,2020,3032,1516,1516,404,145,360,95
ZLK,6,2020,2261,1124,1137,308,287,304,87
ZLK,6,2020,2786,1405,1381,539,366,579,105
ZLK,6,2020,3428,1541,1887,431,579,417,123
ZLK,6,2020,3352,1641,1711,513,1166,1850,105
MSK,6,2020,3674,1872,1802,504,187,142,130
MSK,6,2020,5002,2215,2787,725,398,381,141
MSK,6,2020,13464,6103,7361,1287,284,371,324
MSK,6,2020,3843,1778,2065,622,444,826,91
MSK,6,2020,3554,1635,1919,542,510,570,140
MSK,6,2020,14660,7333,7327,1684,881,954,472
PHA,7,2020,29567,15075,14492,5216,5570,5867,545
STC,7,2020,1589,853,736,293,177,403,16
STC,7,2020,2273,1125,1148,350,531,406,78
STC,7,2020,5295,2749,2546,678,345,447,157
STC,7,2020,2956,1603,1353,455,808,1223,114
STC,7,2020,1770,956,814,295,269,303,67
STC,7,2020,3037,1674,1363,430,654,1270,112
STC,7,2020,2239,1194,1045,403,635,917,58
STC,7,2020,2827,1482,1345,451,937,1267,105
STC,7,2020,2530,1380,1150,452,3082,3633,80
STC,7,2020,2566,1357,1209,423,1282,1414,59
STC,7,2020,3193,1546,1647,465,719,997,98
STC,7,2020,1173,670,503,203,93,92,39
JHC,7,2020,3480,1803,1677,676,555,903,150
JHC,7,2020,1849,922,927,279,364,312,64
JHC,7,2020,1340,756,584,283,203,206,54
JHC,7,2020,1249,724,525,240,330,460,52
JHC,7,2020,910,455,455,172,303,350,47
JHC,7,2020,1570,868,702,261,355,319,49
JHC,7,2020,2320,1220,1100,385,205,319,99
PLK,7,2020,1371,700,671,208,496,555,70
PLK,7,2020,1582,831,751,310,507,562,62
PLK,7,2020,5043,2586,2457,818,1578,1512,147
PLK,7,2020,1113,596,517,212,711,270,52
PLK,7,2020,1827,916,911,299,150,102,51
PLK,7,2020,1156,600,556,177,245,51,31
PLK,7,2020,1461,702,759,262,648,304,45
KVK,7,2020,2687,1365,1322,477,399,456,69
KVK,7,2020,4186,2153,2033,609,421,258,114
KVK,7,2020,3586,1799,1787,510,133,83,119
ULK,7,2020,4688,2427,2261,624,155,142,156
ULK,7,2020,5673,2958,2715,694,2060,1910,197
ULK,7,2020,2853,1629,1224,555,384,238,92
ULK,7,2020,3425,1844,1581,474,240,427,130
ULK,7,2020,5137,2802,2335,688,135,73,178
ULK,7,2020,4049,2149,1900,587,496,448,146
ULK,7,2020,4514,2298,2216,624,297,297,157
LBK,7,2020,2659,1409,1250,468,197,325,117
LBK,7,2020,2580,1336,1244,421,149,160,99
LBK,7,2020,5314,2753,2561,901,1303,920,164
LBK,7,2020,1847,932,915,286,279,406,78
HKK,7,2020,3567,1823,1744,619,608,798,172
HKK,7,2020,1380,686,694,247,252,392,52
HKK,7,2020,2709,1361,1348,433,233,333,92
HKK,7,2020,977,545,432,229,253,227,29
HKK,7,2020,2557,1293,1264,481,272,358,109
PAK,7,2020,1917,1008,909,394,280,173,72
PAK,7,2020,3346,1778,1568,652,3738,2743,136
PAK,7,2020,1903,945,958,366,703,461,51
PAK,7,2020,2373,1246,1127,441,410,409,87
VYS,7,2020,1900,1065,835,320,170,89,60
VYS,7,2020,2573,1341,1232,494,631,661,113
VYS,7,2020,1036,545,491,215,366,403,40
VYS,7,2020,2897,1593,1304,436,107,138,120
VYS,7,2020,2600,1301,1299,442,365,163,85
JHM,7,2020,2531,1236,1295,391,125,124,107
JHM,7,2020,13162,6923,6239,1702,1367,1461,458
JHM,7,2020,4766,2489,2277,747,1639,1309,186
JHM,7,2020,2783,1376,1407,426,635,597,130
JHM,7,2020,5315,2601,2714,723,732,912,211
JHM,7,2020,1723,899,824,317,180,165,56
JHM,7,2020,4129,2145,1984,564,532,439,162
OLK,7,2020,1280,613,667,160,85,82,33
OLK,7,2020,5376,2619,2757,1131,551,707,249
OLK,7,2020,2038,1119,919,368,225,161,63
OLK,7,2020,3763,2044,1719,584,264,307,139
OLK,7,2020,3146,1607,1539,522,201,120,111
ZLK,7,2020,2273,1139,1134,425,236,172,81
ZLK,7,2020,2841,1473,1368,495,319,329,105
ZLK,7,2020,3520,1643,1877,548,553,562,116
ZLK,7,2020,3407,1712,1695,647,957,417,115
MSK,7,2020,3683,1910,1773,474,219,270,125
MSK,7,2020,5151,2332,2819,818,365,321,146
MSK,7,2020,13722,6274,7448,1350,261,311,349
MSK,7,2020,4029,1916,2113,748,299,223,97
MSK,7,2020,3685,1732,1953,595,299,433,147
MSK,7,2020,15131,7651,7480,1776,684,760,500
PHA,8,2020,30556,15708,14848,4327,5249,2177,604
STC,8,2020,1560,813,747,240,321,256,34
STC,8,2020,2268,1117,1151,291,487,390,85
STC,8,2020,5346,2765,2581,574,661,798,159
STC,8,2020,2906,1597,1309,379,1215,1271,134
STC,8,2020,1765,967,798,227,361,268,70
STC,8,2020,2988,1635,1353,380,498,747,118
STC,8,2020,2219,1180,1039,287,886,788,73
STC,8,2020,2825,1483,1342,347,786,914,114
STC,8,2020,2493,1375,1118,351,2764,1806,90
STC,8,2020,2595,1370,1225,317,1261,1181,69
STC,8,2020,3177,1551,1626,382,502,517,96
STC,8,2020,1099,632,467,129,119,35,43
JHC,8,2020,3581,1834,1747,515,606,453,168
JHC,8,2020,1793,901,892,203,562,305,65
JHC,8,2020,1255,714,541,190,213,208,57
JHC,8,2020,1133,659,474,198,493,537,59
JHC,8,2020,862,438,424,134,278,134,48
JHC,8,2020,1528,844,684,188,361,381,48
JHC,8,2020,2232,1201,1031,268,334,179,116
PLK,8,2020,1385,716,669,188,618,531,82
PLK,8,2020,1577,845,732,256,488,464,75
PLK,8,2020,4908,2545,2363,606,1056,848,168
PLK,8,2020,1124,611,513,196,859,233,61
PLK,8,2020,1865,948,917,286,415,974,63
PLK,8,2020,1170,607,563,149,269,228,35
PLK,8,2020,1426,703,723,204,861,264,46
KVK,8,2020,2589,1315,1274,314,382,297,64
KVK,8,2020,4116,2101,2015,446,418,279,116
KVK,8,2020,3538,1791,1747,342,92,129,125
ULK,8,2020,4637,2416,2221,499,176,112,170
ULK,8,2020,5632,2928,2704,618,1770,1617,206
ULK,8,2020,2820,1580,1240,441,187,244,112
ULK,8,2020,3426,1834,1592,394,278,216,158
ULK,8,2020,5305,2862,2443,591,175,152,216
ULK,8,2020,4118,2172,1946,532,406,402,157
ULK,8,2020,4568,2289,2279,488,196,406,145
LBK,8,2020,2588,1395,1193,356,353,342,116
LBK,8,2020,2520,1334,1186,295,291,200,108
LBK,8,2020,5351,2781,2570,711,1272,770,182
LBK,8,2020,1856,944,912,225,594,454,91
HKK,8,2020,3553,1822,1731,468,597,719,188
HKK,8,2020,1345,673,672,219,393,487,66
HKK,8,2020,2701,1377,1324,353,209,212,101
HKK,8,2020,984,543,441,193,303,263,46
HKK,8,2020,2506,1278,1228,336,269,283,105
PAK,8,2020,1848,1007,841,285,310,464,85
PAK,8,2020,3289,1773,1516,465,2652,2931,132
PAK,8,2020,1935,983,952,298,729,684,67
PAK,8,2020,2351,1247,1104,351,221,327,91
VYS,8,2020,1895,1050,845,252,210,163,68
VYS,8,2020,2581,1354,1227,380,344,673,145
VYS,8,2020,980,533,447,174,409,283,36
VYS,8,2020,2829,1546,1283,315,133,79,156
VYS,8,2020,2594,1321,1273,367,175,234,119
JHM,8,2020,2489,1229,1260,266,157,139,110
JHM,8,2020,13479,7019,6460,1444,1259,1096,510
JHM,8,2020,4850,2533,2317,633,1266,1402,209
JHM,8,2020,2662,1334,1328,320,492,485,126
JHM,8,2020,5311,2607,2704,556,725,659,233
JHM,8,2020,1677,883,794,207,114,144,59
JHM,8,2020,4052,2133,1919,451,431,578,186
OLK,8,2020,1185,578,607,110,98,96,30
OLK,8,2020,5439,2635,2804,804,677,421,274
OLK,8,2020,1965,1091,874,302,169,154,65
OLK,8,2020,3893,2094,1799,552,273,328,163
OLK,8,2020,3124,1606,1518,371,193,159,131
ZLK,8,2020,2251,1141,1110,342,172,217,99
ZLK,8,2020,2793,1462,1331,366,456,367,115
ZLK,8,2020,3443,1646,1797,471,398,317,154
ZLK,8,2020,3387,1707,1680,523,708,858,132
MSK,8,2020,3752,1970,1782,448,276,221,124
MSK,8,2020,5041,2301,2740,652,409,315,178
MSK,8,2020,13636,6286,7350,1055,254,247,392
MSK,8,2020,3944,1889,2055,501,342,203,94
MSK,8,2020,3639,1701,1938,458,372,285,148
MSK,8,2020,14975,7593,7382,1314,918,686,518
PHA,9,2020,31056,15853,15203,5368,4251,11034,871
STC,9,2020,1584,804,780,432,348,832,94
STC,9,2020,2231,1100,1131,395,447,523,155
STC,9,2020,5399,2793,2606,831,834,1415,304
STC,9,2020,2905,1590,1315,628,676,1471,206
STC,9,2020,1764,945,819,405,251,308,112
STC,9,2020,3084,1645,1439,639,636,859,207
STC,9,2020,2135,1138,997,387,1644,1291,135
STC,9,2020,2841,1468,1373,557,790,670,167
STC,9,2020,2458,1340,1118,561,2902,6393,140
STC,9,2020,2659,1383,1276,499,1884,1917,112
STC,9,2020,3246,1594,1652,647,666,1314,200
STC,9,2020,1118,636,482,294,146,292,112
JHC,9,2020,3632,1835,1797,751,767,873,225
JHC,9,2020,1679,848,831,292,374,544,88
JHC,9,2020,1187,678,509,287,363,403,74
JHC,9,2020,1043,592,451,288,599,521,100
JHC,9,2020,850,443,407,196,243,638,78
JHC,9,2020,1535,845,690,351,351,312,99
JHC,9,2020,2207,1173,1034,491,451,456,159
PLK,9,2020,1400,706,694,257,1320,1638,111
PLK,9,2020,1533,829,704,360,440,813,117
PLK,9,2020,4791,2468,2323,846,1579,3563,227
PLK,9,2020,1046,561,485,198,849,580,69
PLK,9,2020,1841,927,914,400,381,510,124
PLK,9,2020,1174,613,561,239,428,186,68
PLK,9,2020,1388,662,726,260,1357,1865,87
KVK,9,2020,2452,1232,1220,453,881,668,114
KVK,9,2020,4106,2064,2042,647,410,641,213
KVK,9,2020,3450,1713,1737,648,113,222,196
ULK,9,2020,4635,2402,2233,762,314,432,264
ULK,9,2020,5530,2852,2678,851,2159,2513,316
ULK,9,2020,2729,1513,1216,598,344,358,184
ULK,9,2020,3394,1758,1636,557,271,591,229
ULK,9,2020,5317,2800,2517,743,193,306,324
ULK,9,2020,4237,2242,1995,776,467,433,247
ULK,9,2020,4623,2307,2316,713,154,444,207
LBK,9,2020,2540,1366,1174,569,442,470,186
LBK,9,2020,2483,1300,1183,483,340,305,160
LBK,9,2020,5178,2674,2504,881,2029,1832,245
LBK,9,2020,1889,958,931,386,572,696,128
HKK,9,2020,3469,1696,1773,685,577,531,234
HKK,9,2020,1238,630,608,286,304,283,93
HKK,9,2020,2659,1315,1344,528,275,302,164
HKK,9,2020,994,547,447,277,585,580,104
HKK,9,2020,2519,1227,1292,537,382,376,176
PAK,9,2020,1811,966,845,484,419,476,180
PAK,9,2020,3162,1689,1473,718,1834,5457,195
PAK,9,2020,1876,932,944,447,736,1330,126
PAK,9,2020,2262,1169,1093,539,539,1417,157
VYS,9,2020,1836,1032,804,370,270,328,114
VYS,9,2020,2388,1237,1151,502,447,560,192
VYS,9,2020,975,517,458,268,522,980,65
VYS,9,2020,2756,1470,1286,533,327,505,256
VYS,9,2020,2572,1293,1279,516,243,170,197
JHM,9,2020,2438,1183,1255,440,217,308,163
JHM,9,2020,13429,6874,6555,1844,1599,885,682
JHM,9,2020,4884,2487,2397,982,1846,1449,351
JHM,9,2020,2575,1291,1284,585,545,771,199
JHM,9,2020,5225,2541,2684,854,670,902,357
JHM,9,2020,1718,907,811,398,511,599,132
JHM,9,2020,3971,2048,1923,687,224,383,252
OLK,9,2020,1176,563,613,242,58,93,71
OLK,9,2020,5429,2600,2829,1172,551,557,394
OLK,9,2020,1871,1059,812,428,371,401,125
OLK,9,2020,3890,2068,1822,721,320,298,259
OLK,9,2020,3082,1541,1541,633,189,278,211
ZLK,9,2020,2157,1075,1082,459,270,345,150
ZLK,9,2020,2835,1473,1362,598,253,325,195
ZLK,9,2020,3381,1591,1790,699,609,748,252
ZLK,9,2020,3423,1694,1729,760,796,1207,230
MSK,9,2020,3722,1964,1758,565,156,406,182
MSK,9,2020,4949,2257,2692,975,325,409,302
MSK,9,2020,13607,6193,7414,1637,400,508,564
MSK,9,2020,3813,1816,1997,749,1021,453,207
MSK,9,2020,3673,1665,2008,741,491,441,251
MSK,9,2020,14901,7483,7418,2089,1014,1534,732
PHA,10,2020,31302,15965,15337,4523,4367,2849,907
STC,10,2020,1554,810,744,302,327,191,92
STC,10,2020,2218,1114,1104,304,283,403,152
STC,10,2020,5343,2780,2563,609,367,273,296
STC,10,2020,2790,1521,1269,363,462,478,190
STC,10,2020,1684,914,770,248,409,255,101
STC,10,2020,3090,1683,1407,481,471,484,205
STC,10,2020,2010,1097,913,267,900,484,138
STC,10,2020,2881,1488,1393,394,419,744,179
STC,10,2020,2437,1326,1111,406,1915,3004,161
STC,10,2020,2724,1440,1284,405,1657,1661,129
STC,10,2020,3241,1593,1648,425,477,629,188
STC,10,2020,1071,600,471,151,64,41,98
JHC,10,2020,3644,1858,1786,574,543,584,236
JHC,10,2020,1685,885,800,313,197,205,83
JHC,10,2020,1173,671,502,248,116,101,71
JHC,10,2020,1009,568,441,200,331,333,85
JHC,10,2020,843,459,384,157,255,414,74
JHC,10,2020,1478,831,647,210,361,475,93
JHC,10,2020,2096,1123,973,296,241,343,139
PLK,10,2020,1345,679,666,159,684,1228,95
PLK,10,2020,1497,819,678,274,369,344,116
PLK,10,2020,4499,2352,2147,612,1078,919,196
PLK,10,2020,1004,535,469,162,397,734,65
PLK,10,2020,1778,890,888,241,376,374,111
PLK,10,2020,1087,583,504,123,334,193,49
PLK,10,2020,1345,648,697,200,868,1613,74
KVK,10,2020,2439,1237,1202,360,413,791,122
KVK,10,2020,4224,2155,2069,621,257,549,208
KVK,10,2020,3361,1685,1676,453,64,38,197
ULK,10,2020,4502,2379,2123,561,145,105,268
ULK,10,2020,5289,2792,2497,548,914,1146,266
ULK,10,2020,2690,1490,1200,412,91,168,186
ULK,10,2020,3249,1689,1560,360,210,112,192
ULK,10,2020,5056,2698,2358,460,72,91,312
ULK,10,2020,4219,2248,1971,547,280,588,278
ULK,10,2020,4493,2268,2225,490,127,156,223
LBK,10,2020,2413,1332,1081,349,332,351,181
LBK,10,2020,2410,1292,1118,345,250,289,148
LBK,10,2020,5051,2659,2392,674,967,1288,244
LBK,10,2020,1855,950,905,274,185,294,134
HKK,10,2020,3427,1655,1772,510,639,637,232
HKK,10,2020,1167,611,556,210,278,236,96
HKK,10,2020,2552,1277,1275,362,252,150,149
HKK,10,2020,973,552,421,190,272,317,84
HKK,10,2020,2446,1211,1235,381,325,206,155
PAK,10,2020,1777,950,827,326,294,295,159
PAK,10,2020,3090,1668,1422,535,1281,2851,207
PAK,10,2020,1815,903,912,285,432,515,115
PAK,10,2020,2187,1152,1035,410,372,427,152
VYS,10,2020,1734,988,746,228,156,197,107
VYS,10,2020,2277,1204,1073,348,450,427,176
VYS,10,2020,908,491,417,177,334,214,59
VYS,10,2020,2665,1447,1218,316,169,224,222
VYS,10,2020,2512,1299,1213,351,171,238,189
JHM,10,2020,2351,1154,1197,261,126,137,143
JHM,10,2020,13463,6872,6591,1519,1084,711,672
JHM,10,2020,4775,2457,2318,640,1445,1823,317
JHM,10,2020,2556,1330,1226,407,352,497,189
JHM,10,2020,5141,2522,2619,580,737,840,327
JHM,10,2020,1666,886,780,248,139,65,130
JHM,10,2020,3964,2071,1893,545,138,241,256
OLK,10,2020,1182,582,600,184,34,61,67
OLK,10,2020,5307,2555,2752,784,462,669,347
OLK,10,2020,1873,1053,820,318,183,125,122
OLK,10,2020,3868,2055,1813,475,162,206,254
OLK,10,2020,3025,1516,1509,400,290,228,172
ZLK,10,2020,2078,1027,1051,324,225,222,128
ZLK,10,2020,2779,1475,1304,391,460,447,182
ZLK,10,2020,3333,1594,1739,488,578,679,212
ZLK,10,2020,3360,1693,1667,574,758,1194,189
MSK,10,2020,3636,1930,1706,419,92,106,173
MSK,10,2020,4744,2189,2555,657,235,370,243
MSK,10,2020,13369,6088,7281,1017,309,192,512
MSK,10,2020,3590,1756,1834,494,378,326,190
MSK,10,2020,3560,1649,1911,500,285,580,253
MSK,10,2020,14456,7283,7173,1284,519,944,680
PHA,11,2020,31473,16145,15328,3891,4538,2191,856
STC,11,2020,1575,833,742,308,239,88,83
STC,11,2020,2232,1127,1105,288,396,667,141
STC,11,2020,5328,2781,2547,504,224,68,273
STC,11,2020,2780,1523,1257,357,537,508,177
STC,11,2020,1694,926,768,242,184,384,96
STC,11,2020,3160,1727,1433,399,685,316,187
STC,11,2020,1958,1080,878,263,889,684,122
STC,11,2020,2975,1525,1450,385,711,392,167
STC,11,2020,2476,1355,1121,383,2033,1871,148
STC,11,2020,2814,1479,1335,381,1036,999,129
STC,11,2020,3289,1636,1653,434,663,438,161
STC,11,2020,1081,595,486,145,84,121,82
JHC,11,2020,3700,1888,1812,545,646,483,228
JHC,11,2020,1819,953,866,338,318,198,75
JHC,11,2020,1297,742,555,292,180,136,73
JHC,11,2020,1104,610,494,250,349,299,82
JHC,11,2020,849,466,383,150,491,194,57
JHC,11,2020,1539,874,665,263,428,421,82
JHC,11,2020,2142,1145,997,300,380,274,148
PLK,11,2020,1366,693,673,185,686,797,86
PLK,11,2020,1637,899,738,350,398,381,105
PLK,11,2020,4385,2328,2057,568,1210,881,175
PLK,11,2020,1000,534,466,133,316,456,55
PLK,11,2020,1823,916,907,280,251,76,99
PLK,11,2020,1086,587,499,135,571,82,39
PLK,11,2020,1292,636,656,171,735,374,59
KVK,11,2020,2451,1266,1185,391,381,434,102
KVK,11,2020,4358,2232,2126,526,167,169,211
KVK,11,2020,3389,1701,1688,393,159,101,196
ULK,11,2020,4581,2443,2138,566,151,227,239
ULK,11,2020,5169,2782,2387,506,1577,1700,233
ULK,11,2020,2745,1531,1214,432,269,119,165
ULK,11,2020,3189,1689,1500,337,206,396,172
ULK,11,2020,4951,2649,2302,440,113,93,298
ULK,11,2020,4143,2208,1935,429,408,171,245
ULK,11,2020,4471,2267,2204,429,113,138,203
LBK,11,2020,2417,1317,1100,369,292,277,168
LBK,11,2020,2376,1296,1080,305,179,147,126
LBK,11,2020,5108,2676,2432,675,1463,1231,228
LBK,11,2020,1886,956,930,262,401,368,130
HKK,11,2020,3484,1696,1788,510,380,714,225
HKK,11,2020,1183,626,557,200,258,218,82
HKK,11,2020,2551,1264,1287,358,206,274,123
HKK,11,2020,958,550,408,161,360,170,74
HKK,11,2020,2494,1233,1261,364,238,287,143
PAK,11,2020,1871,988,883,343,351,277,157
PAK,11,2020,3184,1722,1462,534,2235,1584,213
PAK,11,2020,1892,928,964,339,583,335,101
PAK,11,2020,2231,1169,1062,381,236,332,132
VYS,11,2020,1732,977,755,226,192,133,104
VYS,11,2020,2266,1208,1058,363,440,410,161
VYS,11,2020,937,503,434,190,348,272,52
VYS,11,2020,2764,1480,1284,439,56,116,217
VYS,11,2020,2544,1297,1247,359,154,164,174
JHM,11,2020,2341,1148,1193,253,141,135,126
JHM,11,2020,13487,6913,6574,1251,1109,999,651
JHM,11,2020,4806,2490,2316,621,1175,872,279
JHM,11,2020,2763,1440,1323,542,514,327,175
JHM,11,2020,5273,2579,2694,633,662,682,311
JHM,11,2020,1708,911,797,227,138,131,109
JHM,11,2020,4229,2247,1982,700,121,135,253
OLK,11,2020,1392,697,695,343,43,104,69
OLK,11,2020,5471,2671,2800,855,405,382,350
OLK,11,2020,1964,1102,862,300,173,187,126
OLK,11,2020,3911,2077,1834,433,190,290,244
OLK,11,2020,3059,1515,1544,437,234,297,162
ZLK,11,2020,2088,1040,1048,349,207,183,105
ZLK,11,2020,2769,1480,1289,361,425,448,162
ZLK,11,2020,3448,1634,1814,473,457,476,208
ZLK,11,2020,3426,1743,1683,579,659,334,162
MSK,11,2020,3660,1939,1721,417,120,109,153
MSK,11,2020,4839,2253,2586,736,371,246,207
MSK,11,2020,13179,6058,7121,941,207,127,455
MSK,11,2020,3550,1708,1842,447,501,610,165
MSK,11,2020,3619,1679,1940,502,346,334,227
MSK,11,2020,14345,7231,7114,1193,607,613,621
PHA,12,2020,32107,16466,15641,3331,4375,6482,840
STC,12,2020,1662,841,821,284,337,339,75
STC,12,2020,2355,1188,1167,319,420,83,140
STC,12,2020,5507,2848,2659,533,408,615,272
STC,12,2020,3016,1622,1394,449,665,593,173
STC,12,2020,1900,1000,900,370,169,316,93
STC,12,2020,3366,1817,1549,440,827,761,178
STC,12,2020,1982,1084,898,249,724,275,100
STC,12,2020,3104,1555,1549,382,675,762,162
STC,12,2020,2511,1374,1137,290,2555,1500,137
STC,12,2020,2911,1543,1368,321,1685,1546,127
STC,12,2020,3578,1712,1866,549,573,522,163
STC,12,2020,1222,657,565,215,154,167,87
JHC,12,2020,3926,1951,1975,569,495,569,222
JHC,12,2020,2082,1021,1061,393,330,383,78
JHC,12,2020,1616,831,785,431,197,125,74
JHC,12,2020,1248,669,579,277,336,306,80
JHC,12,2020,1050,479,571,299,631,360,56
JHC,12,2020,1742,918,824,375,480,349,80
JHC,12,2020,2432,1204,1228,456,316,357,147
PLK,12,2020,1444,713,731,183,767,534,81
PLK,12,2020,1921,955,966,431,498,240,104
PLK,12,2020,4580,2361,2219,613,1254,534,171
PLK,12,2020,1136,593,543,212,523,259,59
PLK,12,2020,1988,980,1008,300,399,330,102
PLK,12,2020,1155,616,539,157,374,354,38
PLK,12,2020,1449,666,783,270,547,63,56
KVK,12,2020,2602,1339,1263,414,379,448,101
KVK,12,2020,4598,2335,2263,531,207,332,194
KVK,12,2020,3597,1749,1848,523,64,44,181
ULK,12,2020,4916,2586,2330,666,139,97,235
ULK,12,2020,5411,2880,2531,623,1217,1135,240
ULK,12,2020,3021,1640,1381,559,200,244,148
ULK,12,2020,3360,1749,1611,394,334,521,172
ULK,12,2020,5060,2723,2337,429,125,223,281
ULK,12,2020,4215,2241,1974,471,222,506,237
ULK,12,2020,4569,2325,2244,416,114,168,198
LBK,12,2020,2559,1418,1141,400,289,292,161
LBK,12,2020,2466,1319,1147,309,215,189,124
LBK,12,2020,5275,2726,2549,596,1171,1259,225
LBK,12,2020,2064,998,1066,359,261,413,116
HKK,12,2020,3734,1765,1969,581,419,369,210
HKK,12,2020,1263,644,619,240,194,345,79
HKK,12,2020,2834,1314,1520,493,260,147,125
HKK,12,2020,998,583,415,162,269,507,69
HKK,12,2020,2654,1283,1371,435,336,207,143
PAK,12,2020,2241,1066,1175,560,437,464,161
PAK,12,2020,3374,1775,1599,509,2745,2430,205
PAK,12,2020,2210,1008,1202,518,672,618,107
PAK,12,2020,2394,1203,1191,418,236,295,122
VYS,12,2020,1838,975,863,293,170,239,102
VYS,12,2020,2553,1230,1323,545,512,301,152
VYS,12,2020,999,512,487,213,468,446,51
VYS,12,2020,3177,1582,1595,647,83,39,211
VYS,12,2020,2876,1357,1519,559,161,308,165
JHM,12,2020,2477,1183,1294,317,130,134,125
JHM,12,2020,13677,6969,6708,1130,908,722,632
JHM,12,2020,5036,2553,2483,655,1381,1662,276
JHM,12,2020,3194,1595,1599,643,296,390,181
JHM,12,2020,5850,2714,3136,909,685,921,323
JHM,12,2020,1813,915,898,243,266,114,110
JHM,12,2020,4836,2441,2395,883,243,261,263
OLK,12,2020,1626,766,860,307,73,20,72
OLK,12,2020,5904,2761,3143,965,401,727,331
OLK,12,2020,2098,1147,951,313,143,221,119
OLK,12,2020,4222,2169,2053,570,196,154,232
OLK,12,2020,3420,1616,1804,635,132,203,153
ZLK,12,2020,2259,1048,1211,375,128,101,100
ZLK,12,2020,3015,1538,1477,501,613,304,172
ZLK,12,2020,3875,1732,2143,660,410,220,207
ZLK,12,2020,3670,1842,1828,571,726,976,160
MSK,12,2020,4105,1969,2136,729,131,113,160
MSK,12,2020,5141,2326,2815,762,336,385,192
MSK,12,2020,13477,6148,7329,1013,174,259,451
MSK,12,2020,3822,1752,2070,570,538,623,158
MSK,12,2020,3929,1710,2219,615,322,308,213
MSK,12,2020,14683,7344,7339,1216,580,687,607
PHA,1,2021,33217,16986,16231,4420,5966,3950,855
STC,1,2021,1787,893,894,342,267,252,77
STC,1,2021,2469,1227,1242,379,566,717,122
STC,1,2021,5716,2967,2749,684,312,142,273
STC,1,2021,3159,1682,1477,518,832,531,168
STC,1,2021,2029,1043,986,348,222,131,88
STC,1,2021,3631,1941,1690,554,687,460,184
STC,1,2021,2042,1139,903,330,877,802,83
STC,1,2021,3275,1635,1640,461,503,1066,158
STC,1,2021,2636,1427,1209,412,2676,2456,127
STC,1,2021,3022,1598,1424,376,1446,800,129
STC,1,2021,3856,1818,2038,610,655,569,154
STC,1,2021,1361,711,650,257,187,102,77
JHC,1,2021,4181,2035,2146,764,727,663,212
JHC,1,2021,2284,1072,1212,424,481,395,81
JHC,1,2021,1930,915,1015,492,291,184,84
JHC,1,2021,1473,758,715,388,404,388,88
JHC,1,2021,1178,491,687,274,304,452,54
JHC,1,2021,1896,946,950,391,594,458,77
JHC,1,2021,2656,1253,1403,474,399,345,143
PLK,1,2021,1553,763,790,248,568,826,77
PLK,1,2021,2137,1022,1115,476,389,453,105
PLK,1,2021,4772,2495,2277,805,1537,1224,177
PLK,1,2021,1228,630,598,222,570,757,61
PLK,1,2021,2131,1025,1106,339,250,307,97
PLK,1,2021,1197,626,571,178,431,729,34
PLK,1,2021,1578,715,863,281,1083,156,60
KVK,1,2021,2803,1441,1362,462,603,549,93
KVK,1,2021,4877,2467,2410,625,207,415,201
KVK,1,2021,3858,1879,1979,580,67,94,184
ULK,1,2021,5203,2691,2512,710,157,145,232
ULK,1,2021,5636,2975,2661,681,1572,1113,234
ULK,1,2021,3249,1744,1505,549,281,296,146
ULK,1,2021,3584,1874,1710,542,502,354,159
ULK,1,2021,5310,2848,2462,617,113,343,280
ULK,1,2021,4488,2358,2130,677,365,264,230
ULK,1,2021,4767,2436,2331,542,235,150,195
LBK,1,2021,2720,1465,1255,498,343,238,154
LBK,1,2021,2544,1353,1191,365,180,142,125
LBK,1,2021,5502,2825,2677,708,1665,1562,226
LBK,1,2021,2252,1043,1209,430,338,404,116
HKK,1,2021,3876,1829,2047,571,548,434,199
HKK,1,2021,1340,678,662,270,294,332,74
HKK,1,2021,3012,1363,1649,473,323,342,120
HKK,1,2021,1091,619,472,234,553,345,60
HKK,1,2021,2865,1360,1505,522,267,286,145
PAK,1,2021,2545,1168,1377,580,523,408,155
PAK,1,2021,3551,1854,1697,621,3190,2659,210
PAK,1,2021,2386,1060,1326,468,661,397,111
PAK,1,2021,2596,1280,1316,540,392,433,130
VYS,1,2021,1972,1027,945,335,140,96,98
VYS,1,2021,2731,1252,1479,503,562,509,143
VYS,1,2021,1037,515,522,233,393,311,54
VYS,1,2021,3429,1654,1775,539,191,243,198
VYS,1,2021,3103,1427,1676,526,218,314,155
JHM,1,2021,2552,1235,1317,369,175,165,117
JHM,1,2021,13949,7057,6892,1535,1386,830,596
JHM,1,2021,5226,2644,2582,790,1851,1052,266
JHM,1,2021,3411,1648,1763,599,591,327,170
JHM,1,2021,6258,2804,3454,922,880,642,315
JHM,1,2021,1922,970,952,342,283,261,109
JHM,1,2021,5389,2557,2832,1019,256,676,258
OLK,1,2021,1803,819,984,319,59,52,75
OLK,1,2021,6304,2886,3418,1048,551,468,315
OLK,1,2021,2269,1234,1035,412,232,200,118
OLK,1,2021,4454,2205,2249,620,230,310,222
OLK,1,2021,3663,1691,1972,567,247,183,147
ZLK,1,2021,2400,1069,1331,452,165,272,93
ZLK,1,2021,3171,1590,1581,558,445,517,167
ZLK,1,2021,4198,1853,2345,708,582,402,188
ZLK,1,2021,3852,1939,1913,655,757,947,148
MSK,1,2021,4430,2084,2346,671,212,184,169
MSK,1,2021,5471,2473,2998,943,344,360,196
MSK,1,2021,14067,6437,7630,1450,201,351,440
MSK,1,2021,3994,1817,2177,628,639,525,157
MSK,1,2021,4185,1790,2395,720,317,472,213
MSK,1,2021,15170,7580,7590,1605,743,721,609
PHA,2,2021,33565,17208,16357,3555,5623,3834,858
STC,2,2021,1790,922,868,244,213,414,74
STC,2,2021,2489,1235,1254,245,645,465,114
STC,2,2021,5777,3011,2766,527,441,448,272
STC,2,2021,3193,1697,1496,387,761,697,168
STC,2,2021,2043,1074,969,265,267,249,97
STC,2,2021,3706,1993,1713,403,624,439,177
STC,2,2021,2009,1136,873,261,625,1077,87
STC,2,2021,3258,1624,1634,308,1113,1087,156
STC,2,2021,2654,1447,1207,278,2801,2055,130
STC,2,2021,3012,1590,1422,223,1469,272,118
STC,2,2021,3896,1854,2042,404,659,863,159
STC,2,2021,1412,744,668,185,85,160,84
JHC,2,2021,4225,2075,2150,488,935,490,209
JHC,2,2021,2290,1098,1192,212,462,404,76
JHC,2,2021,1980,926,1054,224,247,256,73
JHC,2,2021,1492,787,705,206,415,346,87
JHC,2,2021,1172,497,675,159,246,466,52
JHC,2,2021,1861,928,933,207,294,575,73
JHC,2,2021,2678,1276,1402,284,499,432,138
PLK,2,2021,1551,746,805,154,614,646,74
PLK,2,2021,2134,1013,1121,254,431,326,101
PLK,2,2021,4729,2484,2245,607,1303,1336,175
PLK,2,2021,1251,641,610,188,637,963,59
PLK,2,2021,2144,1011,1133,211,758,449,96
PLK,2,2021,1171,606,565,120,342,571,30
PLK,2,2021,1538,679,859,165,1795,162,52
KVK,2,2021,2853,1451,1402,314,547,569,97
KVK,2,2021,4991,2527,2464,447,282,225,193
KVK,2,2021,4008,1950,2058,433,126,57,182
ULK,2,2021,5252,2696,2556,477,135,162,227
ULK,2,2021,5778,3038,2740,620,2077,1458,236
ULK,2,2021,3355,1800,1555,435,159,280,149
ULK,2,2021,3601,1885,1716,307,321,188,150
ULK,2,2021,5435,2898,2537,487,108,129,280
ULK,2,2021,4607,2411,2196,508,336,277,224
ULK,2,2021,4978,2517,2461,529,310,188,197
LBK,2,2021,2774,1521,1253,403,373,252,142
LBK,2,2021,2608,1380,1228,296,177,342,119
LBK,2,2021,5576,2873,2703,556,1342,1776,226
LBK,2,2021,2282,1035,1247,256,227,389,110
HKK,2,2021,3822,1820,2002,408,707,607,184
HKK,2,2021,1395,710,685,243,280,436,77
HKK,2,2021,2974,1325,1649,293,242,169,117
HKK,2,2021,1083,605,478,164,323,324,45
HKK,2,2021,2959,1423,1536,368,254,277,153
PAK,2,2021,2557,1192,1365,302,499,401,151
PAK,2,2021,3515,1835,1680,441,2633,2639,210
PAK,2,2021,2426,1064,1362,286,607,638,108
PAK,2,2021,2599,1295,1304,306,488,547,127
VYS,2,2021,1944,1036,908,201,143,129,100
VYS,2,2021,2666,1231,1435,254,620,351,135
VYS,2,2021,1027,524,503,170,529,616,52
VYS,2,2021,3411,1653,1758,276,164,157,184
VYS,2,2021,3093,1431,1662,299,207,197,145
JHM,2,2021,2502,1211,1291,247,212,120,104
JHM,2,2021,13982,7103,6879,1216,1395,1415,605
JHM,2,2021,5172,2616,2556,574,1643,2341,253
JHM,2,2021,3400,1641,1759,354,459,291,165
JHM,2,2021,6258,2829,3429,482,640,385,305
JHM,2,2021,1910,961,949,207,216,283,106
JHM,2,2021,5306,2568,2738,469,123,338,226
OLK,2,2021,1841,832,1009,175,39,48,70
OLK,2,2021,6423,2940,3483,777,554,410,312
OLK,2,2021,2262,1262,1000,263,116,230,120
OLK,2,2021,4436,2203,2233,410,379,267,217
OLK,2,2021,3691,1686,2005,360,163,143,152
ZLK,2,2021,2382,1062,1320,254,164,130,92
ZLK,2,2021,3098,1568,1530,342,473,212,156
ZLK,2,2021,4270,1861,2409,473,410,231,191
ZLK,2,2021,3884,1960,1924,480,704,619,150
MSK,2,2021,4467,2096,2371,387,154,123,157
MSK,2,2021,5540,2493,3047,641,295,250,198
MSK,2,2021,14482,6521,7961,1318,188,452,426
MSK,2,2021,4016,1844,2172,455,598,440,138
MSK,2,2021,4195,1789,2406,468,403,494,216
MSK,2,2021,15357,7651,7706,1328,648,702,578
PHA,3,2021,33612,17288,16324,3447,6886,3025,867
STC,3,2021,1748,927,821,242,324,250,69
STC,3,2021,2424,1237,1187,241,615,610,118
STC,3,2021,5747,3019,2728,483,424,56,260
STC,3,2021,3151,1716,1435,397,689,756,143
STC,3,2021,1927,1050,877,189,294,223,84
STC,3,2021,3717,2003,1714,412,591,449,164
STC,3,2021,1910,1095,815,202,987,495,91
STC,3,2021,3243,1652,1591,329,912,1048,149
STC,3,2021,2685,1467,1218,417,3594,2459,138
STC,3,2021,2984,1549,1435,330,2224,3279,118
STC,3,2021,3805,1844,1961,393,792,816,158
STC,3,2021,1373,749,624,164,91,75,83
JHC,3,2021,4140,2094,2046,484,693,773,220
JHC,3,2021,2177,1106,1071,235,289,166,75
JHC,3,2021,1859,931,928,241,339,241,73
JHC,3,2021,1461,781,680,212,556,570,89
JHC,3,2021,1104,518,586,162,387,382,55
JHC,3,2021,1713,931,782,203,481,375,67
JHC,3,2021,2662,1303,1359,315,352,313,148
PLK,3,2021,1545,764,781,167,548,612,78
PLK,3,2021,1974,1002,972,264,671,486,90
PLK,3,2021,4648,2488,2160,580,1540,1259,182
PLK,3,2021,1205,631,574,141,608,1011,58
PLK,3,2021,2089,1020,1069,222,443,166,83
PLK,3,2021,1144,607,537,125,380,223,30
PLK,3,2021,1493,667,826,154,1497,130,45
KVK,3,2021,2901,1460,1441,351,835,760,90
KVK,3,2021,4965,2522,2443,391,294,296,182
KVK,3,2021,4082,1983,2099,424,112,92,185
ULK,3,2021,5236,2698,2538,506,238,170,223
ULK,3,2021,5799,3069,2730,567,1951,1419,243
ULK,3,2021,3334,1779,1555,356,266,189,134
ULK,3,2021,3610,1879,1731,373,555,216,144
ULK,3,2021,5618,3018,2600,580,146,88,274
ULK,3,2021,4594,2447,2147,518,390,252,217
ULK,3,2021,5057,2541,2516,451,178,139,194
LBK,3,2021,2712,1505,1207,365,498,541,136
LBK,3,2021,2645,1406,1239,328,259,161,126
LBK,3,2021,5655,2961,2694,647,1784,1844,230
LBK,3,2021,2196,1031,1165,207,317,244,109
HKK,3,2021,3660,1808,1852,398,625,589,192
HKK,3,2021,1348,722,626,201,355,243,66
HKK,3,2021,2870,1321,1549,302,282,240,106
HKK,3,2021,1070,613,457,158,519,527,46
HKK,3,2021,2957,1431,1526,353,310,176,145
PAK,3,2021,2351,1145,1206,278,520,525,139
PAK,3,2021,3418,1829,1589,453,2858,4434,196
PAK,3,2021,2246,1015,1231,237,577,858,106
PAK,3,2021,2497,1243,1254,321,494,457,124
VYS,3,2021,1914,1046,868,259,142,209,98
VYS,3,2021,2516,1228,1288,297,649,685,118
VYS,3,2021,943,499,444,138,574,486,42
VYS,3,2021,3243,1644,1599,320,152,157,181
VYS,3,2021,2975,1424,1551,301,334,222,151
JHM,3,2021,2450,1186,1264,251,232,139,110
JHM,3,2021,13908,7130,6778,1280,1810,1366,600
JHM,3,2021,5046,2589,2457,553,1921,2135,257
JHM,3,2021,3205,1566,1639,329,638,437,168
JHM,3,2021,6041,2838,3203,505,713,691,292
JHM,3,2021,1838,948,890,208,170,180,99
JHM,3,2021,4946,2540,2406,494,306,157,225
OLK,3,2021,1793,818,975,167,42,59,67
OLK,3,2021,6177,2930,3247,722,516,480,300
OLK,3,2021,2258,1262,996,288,237,175,114
OLK,3,2021,4345,2212,2133,433,462,442,215
OLK,3,2021,3688,1709,1979,436,280,314,145
ZLK,3,2021,2342,1104,1238,327,198,171,91
ZLK,3,2021,2920,1514,1406,322,518,474,150
ZLK,3,2021,4295,1884,2411,476,545,626,184
ZLK,3,2021,3829,1968,1861,476,928,762,151
MSK,3,2021,4341,2115,2226,391,136,171,150
MSK,3,2021,5389,2461,2928,651,367,446,199
MSK,3,2021,14672,6655,8017,1239,287,324,433
MSK,3,2021,3830,1788,2042,452,519,542,125
MSK,3,2021,4010,1797,2213,449,419,282,209
MSK,3,2021,15341,7720,7621,1347,1111,809,569
PHA,4,2021,33352,17161,16191,2890,4504,3199,855
STC,4,2021,1672,907,765,209,359,327,71
STC,4,2021,2357,1215,1142,209,559,520,106
STC,4,2021,5759,3064,2695,472,310,544,259
STC,4,2021,3116,1723,1393,361,1169,622,155
STC,4,2021,1815,1000,815,194,301,239,80
STC,4,2021,3737,2038,1699,372,518,544,155
STC,4,2021,1873,1076,797,219,922,1099,86
STC,4,2021,3122,1649,1473,272,559,760,146
STC,4,2021,2653,1446,1207,295,2660,2433,136
STC,4,2021,2926,1556,1370,272,1526,1724,107
STC,4,2021,3605,1811,1794,328,663,626,146
STC,4,2021,1346,748,598,165,81,55,71
JHC,4,2021,4040,2091,1949,426,829,513,208
JHC,4,2021,2096,1110,986,183,408,438,73
JHC,4,2021,1628,891,737,181,229,208,69
JHC,4,2021,1303,702,601,143,386,314,89
JHC,4,2021,1034,525,509,136,462,284,50
JHC,4,2021,1561,895,666,169,400,415,59
JHC,4,2021,2581,1326,1255,248,401,336,139
PLK,4,2021,1503,769,734,134,532,422,66
PLK,4,2021,1758,958,800,188,484,665,76
PLK,4,2021,4495,2434,2061,502,2126,1392,172
PLK,4,2021,1159,625,534,140,462,56,58
PLK,4,2021,1975,1004,971,179,409,803,79
PLK,4,2021,1125,601,524,116,233,463,29
PLK,4,2021,1348,638,710,131,1951,924,43
KVK,4,2021,2824,1468,1356,273,719,616,92
KVK,4,2021,4875,2486,2389,327,297,182,190
KVK,4,2021,4006,1990,2016,319,142,100,177
ULK,4,2021,5161,2660,2501,450,212,108,213
ULK,4,2021,5681,3021,2660,523,1573,1822,228
ULK,4,2021,3094,1721,1373,348,180,137,122
ULK,4,2021,3558,1881,1677,381,813,1009,134
ULK,4,2021,5724,3068,2656,515,170,182,283
ULK,4,2021,4539,2447,2092,405,474,441,206
ULK,4,2021,5156,2614,2542,435,198,188,191
LBK,4,2021,2571,1439,1132,320,307,455,130
LBK,4,2021,2636,1407,1229,270,209,235,123
LBK,4,2021,5645,2967,2678,584,1672,1363,223
LBK,4,2021,2074,1002,1072,203,216,207,110
HKK,4,2021,3581,1803,1778,403,678,431,192
HKK,4,2021,1279,700,579,181,406,241,65
HKK,4,2021,2712,1301,1411,269,382,134,95
HKK,4,2021,1020,595,425,158,285,421,39
HKK,4,2021,2926,1444,1482,344,274,347,137
PAK,4,2021,2141,1117,1024,223,449,419,126
PAK,4,2021,3255,1767,1488,400,2393,2595,190
PAK,4,2021,1944,940,1004,234,531,322,97
PAK,4,2021,2410,1245,1165,297,446,394,126
VYS,4,2021,1798,1024,774,188,239,182,90
VYS,4,2021,2304,1194,1110,275,779,525,117
VYS,4,2021,890,492,398,136,609,521,35
VYS,4,2021,3010,1580,1430,265,164,210,180
VYS,4,2021,2807,1378,1429,269,298,304,142
JHM,4,2021,2384,1175,1209,216,273,283,95
JHM,4,2021,13612,7010,6602,1022,1348,1265,603
JHM,4,2021,4912,2544,2368,523,1003,1835,244
JHM,4,2021,2970,1512,1458,287,613,514,170
JHM,4,2021,5797,2747,3050,453,829,1104,286
JHM,4,2021,1773,938,835,191,292,297,95
JHM,4,2021,4454,2381,2073,372,466,132,228
OLK,4,2021,1596,764,832,163,86,64,65
OLK,4,2021,5968,2932,3036,630,637,267,284
OLK,4,2021,2199,1237,962,228,216,234,101
OLK,4,2021,4220,2181,2039,334,372,288,209
OLK,4,2021,3450,1701,1749,296,171,149,148
ZLK,4,2021,2241,1112,1129,269,245,132,100
ZLK,4,2021,2815,1507,1308,290,538,598,142
ZLK,4,2021,4131,1869,2262,381,591,424,172
ZLK,4,2021,3755,1961,1794,415,831,810,159
MSK,4,2021,3959,2033,1926,322,169,199,138
MSK,4,2021,5214,2462,2752,656,374,240,191
MSK,4,2021,15168,6728,8440,1535,213,156,418
MSK,4,2021,3666,1774,1892,400,560,588,124
MSK,4,2021,3784,1764,2020,422,384,304,198
MSK,4,2021,15248,7752,7496,1115,797,1122,591
PHA,5,2021,32808,16817,15991,3150,4571,3057,756
STC,5,2021,1526,842,684,200,329,142,53
STC,5,2021,2365,1236,1129,259,546,410,100
STC,5,2021,5694,3051,2643,489,452,671,238
STC,5,2021,2972,1676,1296,323,1176,926,135
STC,5,2021,1668,958,710,199,335,180,70
STC,5,2021,3617,1978,1639,360,793,389,147
STC,5,2021,1842,1066,776,244,1084,706,83
STC,5,2021,2999,1589,1410,323,711,537,134
STC,5,2021,2551,1382,1169,268,2664,3097,109
STC,5,2021,2730,1458,1272,248,1329,2009,89
STC,5,2021,3386,1719,1667,298,935,283,121
STC,5,2021,1265,709,556,150,126,51,56
JHC,5,2021,3926,2039,1887,428,787,775,180
JHC,5,2021,1991,1063,928,181,483,409,71
JHC,5,2021,1415,795,620,163,255,297,59
JHC,5,2021,1235,689,546,168,524,557,79
JHC,5,2021,911,495,416,121,419,399,44
JHC,5,2021,1411,837,574,160,471,420,48
JHC,5,2021,2502,1326,1176,238,366,329,114
PLK,5,2021,1490,778,712,162,543,452,59
PLK,5,2021,1622,891,731,249,561,508,66
PLK,5,2021,4286,2336,1950,551,1985,1121,148
PLK,5,2021,1112,611,501,144,598,450,44
PLK,5,2021,1872,973,899,190,309,519,74
PLK,5,2021,1117,607,510,133,301,437,31
PLK,5,2021,1289,614,675,142,1558,3518,41
KVK,5,2021,2668,1395,1273,235,493,546,84
KVK,5,2021,4675,2423,2252,343,349,235,158
KVK,5,2021,3885,1956,1929,323,111,138,156
ULK,5,2021,4938,2579,2359,427,296,127,188
ULK,5,2021,5523,2954,2569,500,1258,1036,212
ULK,5,2021,2944,1653,1291,384,278,175,108
ULK,5,2021,3477,1854,1623,370,313,456,116
ULK,5,2021,5725,3076,2649,517,132,191,264
ULK,5,2021,4337,2352,1985,421,267,324,188
ULK,5,2021,5107,2597,2510,428,242,243,182
LBK,5,2021,2437,1385,1052,305,361,376,119
LBK,5,2021,2581,1383,1198,295,145,231,108
LBK,5,2021,5590,2944,2646,514,1494,1420,217
LBK,5,2021,1950,993,957,183,254,201,95
HKK,5,2021,3444,1753,1691,388,939,765,169
HKK,5,2021,1178,648,530,173,336,322,62
HKK,5,2021,2568,1269,1299,289,498,358,83
HKK,5,2021,978,568,410,142,431,307,30
HKK,5,2021,2747,1392,1355,292,388,323,118
PAK,5,2021,1934,1066,868,233,348,272,111
PAK,5,2021,3086,1706,1380,423,2271,3410,156
PAK,5,2021,1727,862,865,229,732,447,81
PAK,5,2021,2310,1226,1084,306,605,379,106
VYS,5,2021,1727,996,731,197,234,234,74
VYS,5,2021,2173,1133,1040,302,821,722,100
VYS,5,2021,820,468,352,126,490,493,34
VYS,5,2021,2814,1523,1291,241,133,202,146
VYS,5,2021,2582,1305,1277,221,332,336,114
JHM,5,2021,2298,1169,1129,257,341,171,71
JHM,5,2021,13339,6880,6459,1083,1666,1490,554
JHM,5,2021,4693,2446,2247,499,1470,2523,217
JHM,5,2021,2678,1420,1258,333,573,450,142
JHM,5,2021,5468,2669,2799,447,784,653,243
JHM,5,2021,1675,891,784,206,224,211,79
JHM,5,2021,3957,2152,1805,356,362,395,177
OLK,5,2021,1356,669,687,135,153,62,50
OLK,5,2021,5547,2773,2774,610,671,450,255
OLK,5,2021,1997,1131,866,229,364,187,73
OLK,5,2021,4120,2166,1954,354,522,291,181
OLK,5,2021,3199,1603,1596,327,454,269,132
ZLK,5,2021,2093,1049,1044,241,327,218,80
ZLK,5,2021,2654,1448,1206,281,497,580,120
ZLK,5,2021,3929,1848,2081,408,641,494,145
ZLK,5,2021,3608,1883,1725,455,1279,983,149
MSK,5,2021,3702,1917,1785,341,225,199,113
MSK,5,2021,4929,2384,2545,555,471,268,156
MSK,5,2021,15033,6691,8342,1073,506,191,370
MSK,5,2021,3467,1714,1753,431,818,742,103
MSK,5,2021,3588,1696,1892,434,513,517,162
MSK,5,2021,14965,7652,7313,1156,1150,1314,548
PHA,6,2021,31905,16397,15508,3009,6920,3043,676
STC,6,2021,1364,758,606,205,401,273,43
STC,6,2021,2275,1186,1089,234,538,625,91
STC,6,2021,5589,3008,2581,449,515,335,211
STC,6,2021,2902,1642,1260,360,809,998,113
STC,6,2021,1578,929,649,217,260,262,67
STC,6,2021,3484,1935,1549,314,694,645,129
STC,6,2021,1796,1051,745,243,890,526,71
STC,6,2021,2909,1540,1369,309,714,750,120
STC,6,2021,2420,1308,1112,298,2743,2857,98
STC,6,2021,2555,1378,1177,273,1450,1559,72
STC,6,2021,3214,1637,1577,343,773,578,95
STC,6,2021,1215,694,521,160,288,191,49
JHC,6,2021,3769,1967,1802,409,813,818,153
JHC,6,2021,1770,938,832,165,636,428,63
JHC,6,2021,1207,695,512,170,298,246,49
JHC,6,2021,1156,664,492,195,434,384,65
JHC,6,2021,822,448,374,128,543,437,37
JHC,6,2021,1338,800,538,156,645,517,50
JHC,6,2021,2442,1333,1109,276,388,312,116
PLK,6,2021,1395,742,653,139,702,631,51
PLK,6,2021,1474,814,660,203,721,522,60
PLK,6,2021,4004,2204,1800,476,2651,2740,109
PLK,6,2021,1078,600,478,160,597,252,36
PLK,6,2021,1746,913,833,192,403,196,53
PLK,6,2021,1099,601,498,124,290,277,30
PLK,6,2021,1262,618,644,159,1616,1019,31
KVK,6,2021,2419,1262,1157,253,578,464,76
KVK,6,2021,4320,2259,2061,306,668,436,136
KVK,6,2021,3684,1884,1800,331,154,205,127
ULK,6,2021,4589,2401,2188,415,270,228,159
ULK,6,2021,5411,2899,2512,510,1313,2080,190
ULK,6,2021,2843,1627,1216,414,364,457,97
ULK,6,2021,3472,1879,1593,368,361,365,118
ULK,6,2021,5567,3007,2560,497,176,162,232
ULK,6,2021,4159,2276,1883,433,300,293,176
ULK,6,2021,5058,2567,2491,415,203,189,174
LBK,6,2021,2254,1289,965,275,296,341,101
LBK,6,2021,2448,1335,1113,254,236,154,94
LBK,6,2021,5526,2883,2643,589,1644,1332,205
LBK,6,2021,1842,953,889,184,283,324,75
HKK,6,2021,3337,1724,1613,425,730,819,154
HKK,6,2021,1090,613,477,171,438,275,61
HKK,6,2021,2458,1227,1231,307,453,415,73
HKK,6,2021,923,540,383,142,412,515,25
HKK,6,2021,2528,1299,1229,277,360,266,97
PAK,6,2021,1820,1026,794,234,510,419,103
PAK,6,2021,2896,1619,1277,393,2750,2424,126
PAK,6,2021,1599,822,777,248,593,690,67
PAK,6,2021,2160,1170,990,286,604,885,86
VYS,6,2021,1686,995,691,237,510,155,63
VYS,6,2021,2032,1079,953,282,1038,718,76
VYS,6,2021,756,442,314,152,526,431,31
VYS,6,2021,2631,1414,1217,244,156,91,114
VYS,6,2021,2504,1294,1210,267,359,263,99
JHM,6,2021,2243,1154,1089,263,382,279,63
JHM,6,2021,13112,6793,6319,1118,1888,1583,485
JHM,6,2021,4583,2404,2179,533,1294,992,187
JHM,6,2021,2430,1284,1146,309,618,753,110
JHM,6,2021,5276,2581,2695,503,686,593,207
JHM,6,2021,1551,838,713,177,251,219,68
JHM,6,2021,3615,1980,1635,369,296,302,148
OLK,6,2021,1114,550,564,99,112,93,30
OLK,6,2021,5177,2613,2564,639,906,842,221
OLK,6,2021,1774,1027,747,226,367,214,59
OLK,6,2021,3948,2100,1848,381,347,275,165
OLK,6,2021,2980,1514,1466,330,253,346,109
ZLK,6,2021,1997,1014,983,271,282,211,72
ZLK,6,2021,2520,1404,1116,315,586,506,105
ZLK,6,2021,3693,1768,1925,404,661,895,123
ZLK,6,2021,3412,1779,1633,432,1242,666,131
MSK,6,2021,3495,1828,1667,318,178,160,91
MSK,6,2021,4642,2241,2401,551,400,382,125
MSK,6,2021,14696,6539,8157,1018,395,482,328
MSK,6,2021,3271,1624,1647,393,681,538,95
MSK,6,2021,3397,1598,1799,373,437,307,137
MSK,6,2021,14596,7515,7081,1166,956,772,516
PHA,7,2021,31917,16681,15236,3321,4533,4365,656
STC,7,2021,1362,776,586,255,313,307,45
STC,7,2021,2277,1205,1072,243,382,468,84
STC,7,2021,5616,3055,2561,494,477,376,211
STC,7,2021,2883,1667,1216,371,594,727,113
STC,7,2021,1603,950,653,252,389,443,66
STC,7,2021,3481,1950,1531,408,403,620,126
STC,7,2021,1833,1071,762,279,780,1052,67
STC,7,2021,2943,1591,1352,380,825,616,126
STC,7,2021,2323,1302,1021,351,2996,2990,92
STC,7,2021,2469,1392,1077,284,1550,1127,70
STC,7,2021,3189,1645,1544,372,540,539,99
STC,7,2021,1221,711,510,166,126,194,54
JHC,7,2021,3803,2047,1756,523,552,498,166
JHC,7,2021,1716,924,792,196,337,492,67
JHC,7,2021,1131,670,461,197,275,181,46
JHC,7,2021,1164,673,491,199,455,547,66
JHC,7,2021,782,445,337,101,368,373,36
JHC,7,2021,1337,814,523,177,510,504,49
JHC,7,2021,2439,1361,1078,268,456,347,122
PLK,7,2021,1367,750,617,141,553,1279,66
PLK,7,2021,1433,818,615,226,631,406,56
PLK,7,2021,3982,2205,1777,634,1686,1461,116
PLK,7,2021,1057,583,474,129,567,713,27
PLK,7,2021,1705,912,793,194,432,536,50
PLK,7,2021,1084,626,458,115,442,446,23
PLK,7,2021,1282,639,643,169,3494,3621,36
KVK,7,2021,2339,1227,1112,264,962,367,70
KVK,7,2021,4090,2157,1933,338,336,272,118
KVK,7,2021,3526,1817,1709,321,109,78,126
ULK,7,2021,4474,2392,2082,425,162,165,154
ULK,7,2021,5256,2884,2372,468,1024,1807,177
ULK,7,2021,2759,1620,1139,415,326,260,100
ULK,7,2021,3488,1917,1571,389,404,312,121
ULK,7,2021,5442,2998,2444,413,110,127,205
ULK,7,2021,4105,2252,1853,420,305,252,167
ULK,7,2021,5049,2577,2472,429,181,174,171
LBK,7,2021,2200,1256,944,296,381,303,94
LBK,7,2021,2405,1335,1070,251,220,184,101
LBK,7,2021,5618,2967,2651,611,1591,1524,217
LBK,7,2021,1835,975,860,212,240,145,82
HKK,7,2021,3365,1801,1564,452,653,585,165
HKK,7,2021,1050,615,435,171,364,608,63
HKK,7,2021,2480,1260,1220,369,299,488,78
HKK,7,2021,926,553,373,170,428,318,20
HKK,7,2021,2489,1315,1174,313,325,247,82
PAK,7,2021,1787,1039,748,299,661,271,94
PAK,7,2021,2871,1645,1226,442,1998,1719,119
PAK,7,2021,1606,860,746,271,508,319,68
PAK,7,2021,2148,1193,955,339,436,301,96
VYS,7,2021,1730,1038,692,249,254,174,79
VYS,7,2021,2121,1183,938,385,621,550,87
VYS,7,2021,790,472,318,183,499,415,33
VYS,7,2021,2684,1476,1208,325,109,102,120
VYS,7,2021,2577,1369,1208,364,295,239,99
JHM,7,2021,2306,1200,1106,311,325,291,84
JHM,7,2021,13201,6942,6259,1276,2130,1423,496
JHM,7,2021,4677,2510,2167,591,1712,1308,202
JHM,7,2021,2437,1305,1132,371,585,446,106
JHM,7,2021,5250,2610,2640,540,710,760,206
JHM,7,2021,1578,878,700,219,141,136,67
JHM,7,2021,3565,2003,1562,423,309,309,128
OLK,7,2021,1033,512,521,145,80,68,30
OLK,7,2021,5077,2614,2463,687,706,683,243
OLK,7,2021,1732,1013,719,252,147,77,55
OLK,7,2021,3855,2103,1752,375,314,396,155
OLK,7,2021,2914,1540,1374,384,304,193,105
ZLK,7,2021,1986,1033,953,290,201,164,67
ZLK,7,2021,2563,1467,1096,375,429,440,105
ZLK,7,2021,3643,1776,1867,440,515,347,129
ZLK,7,2021,3426,1826,1600,525,1083,762,131
MSK,7,2021,3494,1867,1627,338,203,168,89
MSK,7,2021,4705,2338,2367,663,338,356,146
MSK,7,2021,14699,6610,8089,1044,182,214,339
MSK,7,2021,3323,1698,1625,471,498,572,110
MSK,7,2021,3437,1665,1772,452,427,306,141
MSK,7,2021,14668,7668,7000,1270,723,1036,535
PHA,8,2021,31271,16458,14813,3184,6201,5162,669
STC,8,2021,1371,800,571,260,306,229,51
STC,8,2021,2266,1213,1053,243,471,451,91
STC,8,2021,5553,3036,2517,468,463,415,233
STC,8,2021,2860,1680,1180,412,694,1193,129
STC,8,2021,1573,908,665,201,259,283,65
STC,8,2021,3399,1941,1458,348,540,457,130
STC,8,2021,1855,1058,797,283,935,820,63
STC,8,2021,2912,1604,1308,329,578,915,141
STC,8,2021,2196,1261,935,318,3001,2530,80
STC,8,2021,2311,1329,982,260,1879,985,78
STC,8,2021,3146,1617,1529,341,743,823,118
STC,8,2021,1210,710,500,171,176,67,69
JHC,8,2021,3733,2031,1702,441,846,950,179
JHC,8,2021,1647,910,737,163,504,290,58
JHC,8,2021,1081,637,444,161,217,330,49
JHC,8,2021,1128,673,455,185,612,414,66
JHC,8,2021,786,452,334,137,268,342,44
JHC,8,2021,1335,814,521,192,677,532,52
JHC,8,2021,2412,1337,1075,267,463,498,117
PLK,8,2021,1349,754,595,143,709,863,86
PLK,8,2021,1432,813,619,216,598,366,68
PLK,8,2021,3874,2194,1680,545,1710,2454,143
PLK,8,2021,1060,587,473,162,521,477,33
PLK,8,2021,1659,892,767,200,279,274,59
PLK,8,2021,1074,624,450,120,542,213,29
PLK,8,2021,1284,639,645,157,2795,1471,33
KVK,8,2021,2270,1196,1074,236,964,827,71
KVK,8,2021,3838,2032,1806,283,385,282,95
KVK,8,2021,3271,1704,1567,298,140,92,119
ULK,8,2021,4290,2329,1961,427,191,122,161
ULK,8,2021,5247,2887,2360,504,1256,1191,186
ULK,8,2021,2642,1584,1058,360,273,159,107
ULK,8,2021,3443,1913,1530,331,337,394,129
ULK,8,2021,5298,2945,2353,440,152,148,213
ULK,8,2021,4002,2215,1787,406,307,337,173
ULK,8,2021,4897,2528,2369,379,250,192,172
LBK,8,2021,2185,1252,933,318,314,424,96
LBK,8,2021,2391,1331,1060,270,456,278,117
LBK,8,2021,5575,2961,2614,600,1371,919,234
LBK,8,2021,1856,992,864,238,246,175,96
HKK,8,2021,3424,1846,1578,492,628,786,185
HKK,8,2021,1009,596,413,154,375,255,51
HKK,8,2021,2460,1266,1194,333,253,147,94
HKK,8,2021,936,556,380,170,448,489,31
HKK,8,2021,2439,1318,1121,282,260,319,89
PAK,8,2021,1754,1044,710,269,388,687,93
PAK,8,2021,2844,1644,1200,395,2363,3006,131
PAK,8,2021,1605,873,732,289,586,437,82
PAK,8,2021,2115,1170,945,312,499,502,92
VYS,8,2021,1752,1052,700,234,295,231,97
VYS,8,2021,2126,1228,898,313,1118,815,106
VYS,8,2021,803,475,328,163,512,835,43
VYS,8,2021,2678,1481,1197,311,105,76,134
VYS,8,2021,2593,1407,1186,328,340,265,126
JHM,8,2021,2245,1178,1067,191,302,304,91
JHM,8,2021,13114,6947,6167,1232,1602,1376,538
JHM,8,2021,4647,2514,2133,532,1326,1299,207
JHM,8,2021,2445,1332,1113,326,707,519,118
JHM,8,2021,5266,2656,2610,528,661,519,233
JHM,8,2021,1573,887,686,205,208,190,65
JHM,8,2021,3525,1997,1528,451,375,273,141
OLK,8,2021,975,503,472,142,75,55,28
OLK,8,2021,4950,2603,2347,713,768,969,260
OLK,8,2021,1701,991,710,246,247,171,61
OLK,8,2021,3741,2087,1654,364,347,266,158
OLK,8,2021,2851,1517,1334,339,341,221,117
ZLK,8,2021,1974,1027,947,313,272,268,78
ZLK,8,2021,2531,1429,1102,372,552,372,112
ZLK,8,2021,3543,1752,1791,373,693,455,141
ZLK,8,2021,3312,1785,1527,440,1127,1231,150
MSK,8,2021,3482,1893,1589,325,161,174,104
MSK,8,2021,4653,2310,2343,603,442,378,163
MSK,8,2021,14631,6652,7979,1016,247,228,371
MSK,8,2021,3317,1723,1594,433,552,453,111
MSK,8,2021,3455,1694,1761,474,529,580,163
MSK,8,2021,14438,7601,6837,1191,930,806,535
PHA,9,2021,29926,15619,14307,3847,4555,4109,877
STC,9,2021,1327,755,572,349,312,299,101
STC,9,2021,2263,1181,1082,360,383,396,158
STC,9,2021,5545,3003,2542,712,337,306,342
STC,9,2021,2834,1636,1198,564,760,736,201
STC,9,2021,1583,898,685,397,247,427,131
STC,9,2021,3385,1916,1469,546,520,697,224
STC,9,2021,1938,1100,838,410,889,940,130
STC,9,2021,2894,1562,1332,564,666,740,210
STC,9,2021,1989,1131,858,423,4144,4066,123
STC,9,2021,2131,1206,925,383,1845,2463,93
STC,9,2021,3056,1549,1507,498,790,511,204
STC,9,2021,1203,691,512,255,138,182,107
JHC,9,2021,3554,1904,1650,578,718,804,215
JHC,9,2021,1603,854,749,251,289,366,88
JHC,9,2021,1092,626,466,276,237,233,91
JHC,9,2021,1095,644,451,272,314,441,98
JHC,9,2021,799,413,386,199,325,301,63
JHC,9,2021,1326,778,548,291,703,753,79
JHC,9,2021,2295,1233,1062,339,410,444,145
PLK,9,2021,1327,720,607,211,539,510,110
PLK,9,2021,1441,787,654,365,561,353,117
PLK,9,2021,3708,2091,1617,724,1656,1570,191
PLK,9,2021,1035,576,459,200,542,1543,73
PLK,9,2021,1638,876,762,318,284,274,118
PLK,9,2021,1126,649,477,222,256,237,76
PLK,9,2021,1218,606,612,198,1584,2330,72
KVK,9,2021,2186,1109,1077,349,678,810,124
KVK,9,2021,3698,1936,1762,515,328,403,182
KVK,9,2021,3186,1682,1504,519,131,137,213
ULK,9,2021,4168,2271,1897,706,361,289,278
ULK,9,2021,5226,2852,2374,725,1119,1430,290
ULK,9,2021,2596,1529,1067,573,208,324,197
ULK,9,2021,3509,1926,1583,564,375,402,265
ULK,9,2021,5275,2943,2332,707,155,173,350
ULK,9,2021,3926,2161,1765,648,203,281,269
ULK,9,2021,4916,2517,2399,650,190,183,280
LBK,9,2021,2179,1216,963,500,311,368,177
LBK,9,2021,2387,1318,1069,433,200,429,168
LBK,9,2021,5297,2803,2494,777,1104,1246,275
LBK,9,2021,1796,967,829,321,268,298,130
HKK,9,2021,3284,1722,1562,616,828,492,268
HKK,9,2021,1024,582,442,276,260,545,109
HKK,9,2021,2452,1258,1194,487,398,439,185
HKK,9,2021,949,531,418,255,266,272,66
HKK,9,2021,2449,1301,1148,497,435,223,194
PAK,9,2021,1687,970,717,408,405,663,163
PAK,9,2021,2799,1589,1210,615,1427,2520,207
PAK,9,2021,1560,817,743,382,460,719,144
PAK,9,2021,2050,1148,902,457,509,518,151
VYS,9,2021,1724,1018,706,330,184,206,134
VYS,9,2021,2030,1118,912,432,580,877,166
VYS,9,2021,884,502,382,308,393,513,75
VYS,9,2021,2633,1450,1183,489,158,360,212
VYS,9,2021,2538,1321,1217,479,298,231,212
JHM,9,2021,2234,1169,1065,356,210,332,150
JHM,9,2021,12869,6744,6125,1629,2042,1651,692
JHM,9,2021,4549,2443,2106,765,1389,1495,322
JHM,9,2021,2404,1273,1131,478,335,553,182
JHM,9,2021,5183,2597,2586,722,615,706,372
JHM,9,2021,1589,849,740,346,209,209,124
JHM,9,2021,3476,1933,1543,641,231,256,256
OLK,9,2021,938,492,446,188,60,93,69
OLK,9,2021,4767,2423,2344,946,644,553,398
OLK,9,2021,1658,965,693,348,191,171,93
OLK,9,2021,3647,2021,1626,563,302,312,235
OLK,9,2021,2768,1428,1340,525,361,313,180
ZLK,9,2021,1943,991,952,389,237,271,134
ZLK,9,2021,2487,1391,1096,502,410,495,188
ZLK,9,2021,3396,1656,1740,542,533,422,231
ZLK,9,2021,3125,1619,1506,595,823,963,217
MSK,9,2021,3490,1862,1628,503,156,178,167
MSK,9,2021,4628,2234,2394,878,359,329,295
MSK,9,2021,14482,6557,7925,1360,273,270,549
MSK,9,2021,3315,1678,1637,658,489,543,229
MSK,9,2021,3454,1695,1759,660,424,483,252
MSK,9,2021,14001,7305,6696,1571,896,648,759
PHA,10,2021,28242,14703,13539,3073,5200,6797,843
STC,10,2021,1246,695,551,224,388,245,88
STC,10,2021,2158,1107,1051,272,340,382,135
STC,10,2021,5385,2919,2466,455,383,892,317
STC,10,2021,2739,1564,1175,367,772,0,191
STC,10,2021,1495,847,648,217,167,251,120
STC,10,2021,3306,1871,1435,386,642,512,227
STC,10,2021,1894,1055,839,293,536,877,121
STC,10,2021,2779,1506,1273,340,606,622,189
STC,10,2021,1838,1019,819,294,2430,3597,98
STC,10,2021,1989,1127,862,242,1171,322,94
STC,10,2021,2944,1485,1459,371,775,460,211
STC,10,2021,1162,664,498,151,136,94,100
JHC,10,2021,3432,1850,1582,481,640,700,215
JHC,10,2021,1545,834,711,221,670,531,75
JHC,10,2021,1094,623,471,227,264,343,79
JHC,10,2021,1087,639,448,216,274,416,85
JHC,10,2021,772,411,361,135,199,302,57
JHC,10,2021,1291,750,541,188,504,630,70
JHC,10,2021,2200,1176,1024,272,370,303,142
PLK,10,2021,1218,666,552,135,496,577,94
PLK,10,2021,1349,741,608,222,554,840,91
PLK,10,2021,3577,2000,1577,537,1506,2528,174
PLK,10,2021,1008,552,456,168,485,834,67
PLK,10,2021,1596,854,742,237,251,785,104
PLK,10,2021,1070,633,437,123,145,410,60
PLK,10,2021,1174,573,601,153,1423,2129,68
KVK,10,2021,2044,1065,979,242,946,540,116
KVK,10,2021,3517,1869,1648,393,281,343,198
KVK,10,2021,3051,1621,1430,341,79,64,208
ULK,10,2021,3974,2172,1802,510,182,231,279
ULK,10,2021,5113,2786,2327,526,1315,1048,256
ULK,10,2021,2527,1460,1067,399,173,181,180
ULK,10,2021,3463,1897,1566,399,247,380,259
ULK,10,2021,5012,2784,2228,444,93,155,333
ULK,10,2021,3742,2084,1658,395,212,258,267
ULK,10,2021,4795,2440,2355,408,312,239,273
LBK,10,2021,2161,1226,935,390,186,225,177
LBK,10,2021,2327,1287,1040,288,121,172,150
LBK,10,2021,5108,2685,2423,685,960,1747,270
LBK,10,2021,1756,934,822,233,207,137,121
HKK,10,2021,3121,1647,1474,406,648,1029,229
HKK,10,2021,1026,580,446,228,242,173,101
HKK,10,2021,2358,1188,1170,345,182,276,149
HKK,10,2021,891,494,397,156,181,265,58
HKK,10,2021,2386,1254,1132,371,333,338,177
PAK,10,2021,1630,925,705,287,349,314,144
PAK,10,2021,2658,1523,1135,414,1589,1658,190
PAK,10,2021,1503,783,720,261,408,878,121
PAK,10,2021,1912,1069,843,293,721,353,123
VYS,10,2021,1647,985,662,190,200,242,120
VYS,10,2021,1942,1043,899,309,560,497,149
VYS,10,2021,808,465,343,126,454,330,63
VYS,10,2021,2487,1378,1109,263,260,212,184
VYS,10,2021,2425,1254,1171,284,284,414,182
JHM,10,2021,2164,1139,1025,227,207,226,130
JHM,10,2021,12411,6489,5922,1131,1936,1359,663
JHM,10,2021,4365,2343,2022,503,1881,1404,287
JHM,10,2021,2330,1243,1087,354,466,480,167
JHM,10,2021,5034,2546,2488,471,592,698,345
JHM,10,2021,1496,808,688,217,146,138,115
JHM,10,2021,3400,1856,1544,467,348,588,234
OLK,10,2021,929,485,444,138,77,77,50
OLK,10,2021,4457,2278,2179,601,652,495,337
OLK,10,2021,1616,932,684,282,192,239,74
OLK,10,2021,3458,1921,1537,314,258,193,218
OLK,10,2021,2701,1411,1290,425,249,274,162
ZLK,10,2021,1842,931,911,266,244,214,119
ZLK,10,2021,2425,1344,1081,340,354,248,166
ZLK,10,2021,3211,1557,1654,368,656,626,188
ZLK,10,2021,2879,1477,1402,381,851,871,176
MSK,10,2021,3426,1820,1606,351,165,178,165
MSK,10,2021,4472,2122,2350,575,393,230,246
MSK,10,2021,14179,6415,7764,1063,213,299,509
MSK,10,2021,3177,1610,1567,465,466,585,162
MSK,10,2021,3350,1665,1685,447,404,526,229
MSK,10,2021,13393,6993,6400,1224,858,1091,720
PHA,11,2021,26521,13858,12663,2968,5369,8919,757
STC,11,2021,1166,652,514,228,336,399,62
STC,11,2021,2142,1097,1045,270,401,377,122
STC,11,2021,5211,2823,2388,492,655,563,302
STC,11,2021,2627,1468,1159,374,618,700,161
STC,11,2021,1488,851,637,273,361,472,109
STC,11,2021,3132,1745,1387,365,648,457,204
STC,11,2021,1864,1040,824,278,1158,1143,101
STC,11,2021,2735,1484,1251,345,652,690,160
STC,11,2021,1744,966,778,287,2200,5564,88
STC,11,2021,1875,1050,825,234,1103,2038,68
STC,11,2021,2852,1441,1411,375,475,459,178
STC,11,2021,1120,633,487,164,198,239,76
JHC,11,2021,3202,1713,1489,475,798,509,169
JHC,11,2021,1643,864,779,300,474,482,64
JHC,11,2021,1132,645,487,271,160,201,62
JHC,11,2021,1104,634,470,226,479,367,69
JHC,11,2021,814,433,381,177,186,165,47
JHC,11,2021,1273,726,547,197,716,493,57
JHC,11,2021,2108,1126,982,244,463,394,106
PLK,11,2021,1183,654,529,147,405,559,84
PLK,11,2021,1411,760,651,330,540,719,74
PLK,11,2021,3469,1944,1525,519,3294,1356,167
PLK,11,2021,989,542,447,147,597,502,52
PLK,11,2021,1576,851,725,227,395,256,98
PLK,11,2021,1067,619,448,152,305,414,45
PLK,11,2021,1121,553,568,139,1686,1431,60
KVK,11,2021,1937,1011,926,257,1068,966,106
KVK,11,2021,3371,1776,1595,369,361,413,185
KVK,11,2021,2942,1561,1381,347,126,103,196
ULK,11,2021,3905,2126,1779,511,228,309,254
ULK,11,2021,5002,2749,2253,574,876,1341,231
ULK,11,2021,2491,1418,1073,399,207,214,148
ULK,11,2021,3417,1850,1567,386,335,363,237
ULK,11,2021,4826,2725,2101,483,97,89,302
ULK,11,2021,3589,1984,1605,453,238,242,240
ULK,11,2021,4600,2353,2247,412,157,289,243
LBK,11,2021,2098,1186,912,352,242,344,154
LBK,11,2021,2302,1253,1049,319,177,166,142
LBK,11,2021,4863,2582,2281,625,1187,1527,257
LBK,11,2021,1802,947,855,283,213,260,116
HKK,11,2021,3018,1583,1435,426,512,583,198
HKK,11,2021,1103,622,481,250,284,295,89
HKK,11,2021,2401,1185,1216,406,329,403,139
HKK,11,2021,884,491,393,163,373,458,48
HKK,11,2021,2379,1228,1151,379,341,365,151
PAK,11,2021,1650,937,713,316,342,521,118
PAK,11,2021,2634,1494,1140,477,1621,1438,164
PAK,11,2021,1508,763,745,286,480,551,99
PAK,11,2021,1878,1041,837,320,569,689,105
VYS,11,2021,1624,962,662,227,174,191,110
VYS,11,2021,1917,1007,910,330,662,792,128
VYS,11,2021,767,455,312,151,512,409,53
VYS,11,2021,2513,1365,1148,386,158,178,159
VYS,11,2021,2391,1236,1155,321,361,447,153
JHM,11,2021,2158,1129,1029,260,312,217,112
JHM,11,2021,12126,6343,5783,1107,1989,2192,639
JHM,11,2021,4292,2304,1988,528,960,1115,252
JHM,11,2021,2439,1265,1174,491,450,399,154
JHM,11,2021,5091,2580,2511,578,716,720,335
JHM,11,2021,1447,787,660,216,195,204,85
JHM,11,2021,3495,1918,1577,610,241,390,215
OLK,11,2021,1052,542,510,256,79,49,55
OLK,11,2021,4293,2181,2112,678,588,633,288
OLK,11,2021,1609,914,695,299,237,332,67
OLK,11,2021,3387,1830,1557,403,344,340,195
OLK,11,2021,2685,1375,1310,430,325,293,148
ZLK,11,2021,1782,921,861,267,266,203,92
ZLK,11,2021,2431,1298,1133,380,424,477,144
ZLK,11,2021,3206,1557,1649,444,543,468,168
ZLK,11,2021,2775,1421,1354,411,1002,890,144
MSK,11,2021,3493,1840,1653,413,133,119,163
MSK,11,2021,4354,2057,2297,596,365,429,204
MSK,11,2021,13840,6256,7584,977,297,242,457
MSK,11,2021,3135,1543,1592,493,617,615,129
MSK,11,2021,3344,1636,1708,449,396,514,214
MSK,11,2021,12734,6653,6081,1147,668,1008,666
PHA,12,2021,26047,13657,12390,2781,6385,10187,706
STC,12,2021,1256,675,581,270,269,283,47
STC,12,2021,2237,1127,1110,294,385,248,126
STC,12,2021,5263,2828,2435,482,445,428,290
STC,12,2021,2702,1489,1213,418,531,406,146
STC,12,2021,1685,929,756,362,284,289,113
STC,12,2021,3222,1789,1433,392,631,698,191
STC,12,2021,1944,1076,868,273,910,395,98
STC,12,2021,2846,1524,1322,383,734,733,158
STC,12,2021,1738,972,766,266,3216,1985,77
STC,12,2021,1817,1042,775,230,1942,1882,65
STC,12,2021,3119,1508,1611,544,532,1056,161
STC,12,2021,1190,660,530,183,252,161,73
JHC,12,2021,3286,1690,1596,555,531,585,162
JHC,12,2021,1860,910,950,378,612,582,65
JHC,12,2021,1378,690,688,422,215,219,63
JHC,12,2021,1242,686,556,272,274,399,63
JHC,12,2021,1034,463,571,303,225,230,47
JHC,12,2021,1536,798,738,396,335,657,58
JHC,12,2021,2298,1147,1151,391,263,437,104
PLK,12,2021,1262,676,586,207,664,410,82
PLK,12,2021,1642,790,852,438,500,603,69
PLK,12,2021,3582,2001,1581,534,1960,1185,163
PLK,12,2021,1018,530,488,160,586,773,47
PLK,12,2021,1669,884,785,235,230,233,86
PLK,12,2021,1134,637,497,191,492,411,47
PLK,12,2021,1251,586,665,253,2180,945,56
KVK,12,2021,2025,1058,967,331,548,693,101
KVK,12,2021,3411,1772,1639,406,226,463,169
KVK,12,2021,3001,1592,1409,350,81,111,189
ULK,12,2021,4150,2218,1932,621,91,118,252
ULK,12,2021,5209,2850,2359,632,790,560,235
ULK,12,2021,2799,1564,1235,588,251,208,143
ULK,12,2021,3521,1900,1621,382,228,251,222
ULK,12,2021,4867,2769,2098,489,101,116,290
ULK,12,2021,3665,2044,1621,488,287,225,235
ULK,12,2021,4572,2367,2205,387,259,374,230
LBK,12,2021,2202,1211,991,372,447,861,146
LBK,12,2021,2345,1283,1062,288,206,121,130
LBK,12,2021,4854,2567,2287,585,1082,909,236
LBK,12,2021,1962,968,994,354,210,236,105
HKK,12,2021,3263,1627,1636,567,549,473,184
HKK,12,2021,1232,653,579,263,314,427,91
HKK,12,2021,2670,1242,1428,509,235,351,133
HKK,12,2021,933,508,425,171,286,263,40
HKK,12,2021,2524,1271,1253,408,228,324,147
PAK,12,2021,1967,994,973,527,498,323,110
PAK,12,2021,2830,1565,1265,520,2018,1941,156
PAK,12,2021,1937,902,1035,594,467,376,99
PAK,12,2021,2049,1063,986,432,404,507,103
VYS,12,2021,1798,987,811,326,196,284,114
VYS,12,2021,2226,1045,1181,550,628,666,121
VYS,12,2021,854,471,383,202,464,473,49
VYS,12,2021,2881,1453,1428,597,151,278,165
VYS,12,2021,2654,1268,1386,481,238,332,143
JHM,12,2021,2268,1152,1116,295,240,402,106
JHM,12,2021,12237,6385,5852,1061,1523,941,614
JHM,12,2021,4444,2343,2101,564,1086,976,244
JHM,12,2021,2889,1424,1465,696,308,530,144
JHM,12,2021,5535,2661,2874,829,663,547,317
JHM,12,2021,1540,819,721,237,205,225,79
JHM,12,2021,4110,2139,1971,922,222,181,217
OLK,12,2021,1295,601,694,346,33,39,55
OLK,12,2021,4704,2260,2444,929,544,960,284
OLK,12,2021,1762,991,771,321,213,120,69
OLK,12,2021,3658,1877,1781,581,331,390,191
OLK,12,2021,2963,1414,1549,581,275,229,141
ZLK,12,2021,1918,959,959,349,175,270,89
ZLK,12,2021,2677,1356,1321,495,461,448,142
ZLK,12,2021,3456,1607,1849,545,476,295,164
ZLK,12,2021,2906,1470,1436,512,810,669,135
MSK,12,2021,3967,1923,2044,748,105,227,165
MSK,12,2021,4707,2144,2563,803,381,272,195
MSK,12,2021,13852,6250,7602,1011,205,241,430
MSK,12,2021,3356,1570,1786,563,653,895,126
MSK,12,2021,3682,1684,1998,712,484,400,195
MSK,12,2021,12588,6538,6050,1124,709,919,605
PHA,1,2022,25817,13582,12235,3742,5562,5811,666
STC,1,2022,1327,703,624,367,320,280,48
STC,1,2022,2254,1129,1125,351,582,420,117
STC,1,2022,5301,2844,2457,630,355,354,266
STC,1,2022,2793,1516,1277,541,821,478,153
STC,1,2022,1806,971,835,359,678,398,105
STC,1,2022,3299,1840,1459,492,801,506,183
STC,1,2022,2031,1132,899,389,1468,1016,91
STC,1,2022,2845,1522,1323,409,965,1198,140
STC,1,2022,1668,917,751,322,3469,3359,61
STC,1,2022,1835,1030,805,344,920,544,63
STC,1,2022,3271,1569,1702,569,874,417,157
STC,1,2022,1277,703,574,267,194,117,72
JHC,1,2022,3316,1657,1659,746,883,812,147
JHC,1,2022,2022,957,1065,402,531,454,66
JHC,1,2022,1644,771,873,521,340,266,59
JHC,1,2022,1393,758,635,373,552,515,67
JHC,1,2022,1171,485,686,325,368,250,53
JHC,1,2022,1691,813,878,393,409,476,57
JHC,1,2022,2430,1173,1257,483,451,347,115
PLK,1,2022,1338,685,653,246,510,587,81
PLK,1,2022,1792,813,979,464,473,252,71
PLK,1,2022,3665,2038,1627,716,1950,1540,171
PLK,1,2022,1072,572,500,240,873,733,47
PLK,1,2022,1756,896,860,315,375,358,72
PLK,1,2022,1183,667,516,173,454,0,44
PLK,1,2022,1346,605,741,268,2838,2165,55
KVK,1,2022,2068,1089,979,353,797,553,93
KVK,1,2022,3535,1815,1720,558,365,308,158
KVK,1,2022,3149,1670,1479,557,191,117,175
ULK,1,2022,4432,2323,2109,807,242,175,226
ULK,1,2022,5297,2903,2394,678,1704,1021,243
ULK,1,2022,2937,1602,1335,542,280,342,137
ULK,1,2022,3607,1917,1690,508,386,309,212
ULK,1,2022,5025,2867,2158,708,217,183,291
ULK,1,2022,3884,2160,1724,713,217,304,229
ULK,1,2022,4650,2382,2268,625,281,194,228
LBK,1,2022,2368,1284,1084,492,476,335,136
LBK,1,2022,2338,1253,1085,343,342,316,125
LBK,1,2022,4808,2541,2267,783,1460,660,213
LBK,1,2022,2011,966,1045,351,340,226,100
HKK,1,2022,3361,1639,1722,596,740,471,177
HKK,1,2022,1282,671,611,309,429,406,80
HKK,1,2022,2836,1329,1507,550,564,345,123
HKK,1,2022,1019,556,463,267,471,415,39
HKK,1,2022,2645,1313,1332,511,276,161,137
PAK,1,2022,2165,1019,1146,497,516,403,108
PAK,1,2022,2924,1636,1288,614,2113,1879,147
PAK,1,2022,2134,960,1174,487,712,444,101
PAK,1,2022,2083,1069,1014,430,685,609,90
VYS,1,2022,1859,980,879,344,248,191,104
VYS,1,2022,2374,1096,1278,520,582,739,115
VYS,1,2022,866,467,399,237,535,459,44
VYS,1,2022,3081,1514,1567,559,191,153,153
VYS,1,2022,2783,1301,1482,511,209,82,132
JHM,1,2022,2334,1177,1157,338,358,238,93
JHM,1,2022,12269,6369,5900,1462,2060,1900,576
JHM,1,2022,4682,2439,2243,843,1116,1245,230
JHM,1,2022,3062,1480,1582,557,538,551,143
JHM,1,2022,5923,2808,3115,978,710,775,308
JHM,1,2022,1622,861,761,319,247,293,76
JHM,1,2022,4636,2262,2374,1037,365,294,201
OLK,1,2022,1457,652,805,305,88,113,50
OLK,1,2022,4907,2336,2571,996,778,649,264
OLK,1,2022,1899,1071,828,418,187,234,65
OLK,1,2022,3818,1926,1892,577,397,362,193
OLK,1,2022,3049,1436,1613,577,354,308,137
ZLK,1,2022,2054,1003,1051,441,327,363,92
ZLK,1,2022,2813,1399,1414,579,531,594,145
ZLK,1,2022,3639,1651,1988,652,621,834,142
ZLK,1,2022,2974,1505,1469,621,780,788,112
MSK,1,2022,4140,1980,2160,583,166,164,165
MSK,1,2022,4925,2257,2668,909,379,493,169
MSK,1,2022,14093,6474,7619,1478,262,332,418
MSK,1,2022,3425,1612,1813,614,1019,556,119
MSK,1,2022,3858,1779,2079,709,354,330,200
MSK,1,2022,12633,6580,6053,1658,1011,832,586
PHA,2,2022,25444,13426,12018,3124,6615,3748,657
STC,2,2022,1319,687,632,217,299,229,52
STC,2,2022,2180,1095,1085,220,638,375,102
STC,2,2022,5256,2808,2448,524,559,948,268
STC,2,2022,2794,1537,1257,384,706,446,147
STC,2,2022,1774,946,828,193,425,219,105
STC,2,2022,3242,1814,1428,339,471,554,177
STC,2,2022,1954,1083,871,252,1286,550,81
STC,2,2022,2779,1485,1294,296,809,758,130
STC,2,2022,1599,874,725,252,3729,3380,53
STC,2,2022,1771,991,780,257,2402,1266,64
STC,2,2022,3268,1562,1706,372,593,573,157
STC,2,2022,1267,691,576,152,197,233,64
JHC,2,2022,3196,1609,1587,450,863,743,137
JHC,2,2022,1986,956,1030,228,718,395,63
JHC,2,2022,1593,757,836,205,195,240,69
JHC,2,2022,1352,749,603,181,473,538,61
JHC,2,2022,1141,501,640,148,286,349,50
JHC,2,2022,1641,804,837,188,590,435,44
JHC,2,2022,2381,1153,1228,283,426,438,114
PLK,2,2022,1273,674,599,127,488,392,77
PLK,2,2022,1749,792,957,226,671,716,76
PLK,2,2022,3581,1990,1591,496,1511,1467,174
PLK,2,2022,1100,586,514,191,736,522,51
PLK,2,2022,1712,861,851,204,567,126,70
PLK,2,2022,1161,658,503,143,336,328,46
PLK,2,2022,1321,603,718,160,2581,1904,52
KVK,2,2022,2067,1103,964,262,1182,1080,87
KVK,2,2022,3455,1790,1665,339,419,383,145
KVK,2,2022,3104,1666,1438,409,193,157,161
ULK,2,2022,4422,2361,2061,471,264,215,229
ULK,2,2022,5307,2933,2374,578,1392,1544,237
ULK,2,2022,2991,1629,1362,435,256,216,155
ULK,2,2022,3700,1971,1729,455,426,352,204
ULK,2,2022,4992,2838,2154,499,120,66,284
ULK,2,2022,3899,2154,1745,458,716,336,217
ULK,2,2022,4531,2351,2180,406,359,144,207
LBK,2,2022,2321,1268,1053,322,418,233,146
LBK,2,2022,2397,1278,1119,331,312,252,129
LBK,2,2022,4752,2516,2236,645,1302,1254,209
LBK,2,2022,2011,958,1053,221,285,304,109
HKK,2,2022,3259,1593,1666,405,619,571,175
HKK,2,2022,1238,643,595,174,422,228,71
HKK,2,2022,2796,1318,1478,291,398,431,122
HKK,2,2022,996,553,443,135,333,391,35
HKK,2,2022,2573,1252,1321,286,381,373,126
PAK,2,2022,2186,1022,1164,320,775,453,106
PAK,2,2022,2900,1650,1250,417,2440,2224,149
PAK,2,2022,2105,946,1159,274,586,716,103
PAK,2,2022,2072,1047,1025,288,551,501,83
VYS,2,2022,1801,962,839,218,205,198,94
VYS,2,2022,2311,1058,1253,281,636,544,109
VYS,2,2022,831,463,368,157,524,489,39
VYS,2,2022,3005,1476,1529,277,203,86,137
VYS,2,2022,2772,1280,1492,290,437,393,144
JHM,2,2022,2280,1142,1138,214,477,222,101
JHM,2,2022,12211,6346,5865,1188,2088,1291,602
JHM,2,2022,4512,2336,2176,440,1406,1020,228
JHM,2,2022,2906,1406,1500,289,593,422,140
JHM,2,2022,5821,2752,3069,485,506,353,299
JHM,2,2022,1589,833,756,194,242,315,68
JHM,2,2022,4641,2279,2362,536,310,216,220
OLK,2,2022,1510,667,843,183,107,113,53
OLK,2,2022,4832,2324,2508,636,647,584,249
OLK,2,2022,1832,1058,774,251,202,187,73
OLK,2,2022,3795,1911,1884,400,323,386,179
OLK,2,2022,2937,1367,1570,302,450,390,125
ZLK,2,2022,2013,994,1019,257,304,144,93
ZLK,2,2022,2745,1391,1354,304,434,433,137
ZLK,2,2022,3564,1594,1970,383,673,849,141
ZLK,2,2022,2902,1452,1450,410,981,740,113
MSK,2,2022,4113,1984,2129,350,253,232,159
MSK,2,2022,4821,2178,2643,545,392,410,164
MSK,2,2022,14025,6506,7519,1042,227,195,400
MSK,2,2022,3363,1593,1770,415,953,809,119
MSK,2,2022,3799,1769,2030,407,591,295,200
MSK,2,2022,12594,6513,6081,1236,1079,713,609
PHA,3,2022,24612,13057,11555,3048,6823,4685,680
STC,3,2022,1257,661,596,237,322,277,47
STC,3,2022,2084,1066,1018,266,709,840,102
STC,3,2022,5139,2746,2393,555,452,255,256
STC,3,2022,2730,1540,1190,421,527,798,147
STC,3,2022,1711,920,791,252,477,481,95
STC,3,2022,3270,1823,1447,440,619,646,166
STC,3,2022,1939,1085,854,316,760,1179,83
STC,3,2022,2691,1474,1217,308,491,317,123
STC,3,2022,1516,820,696,296,1911,3559,58
STC,3,2022,1637,928,709,240,1319,2215,50
STC,3,2022,3053,1511,1542,380,466,892,162
STC,3,2022,1147,640,507,139,438,340,66
JHC,3,2022,2887,1487,1400,445,940,1089,136
JHC,3,2022,1757,911,846,176,573,564,60
JHC,3,2022,1329,714,615,219,211,342,64
JHC,3,2022,1250,728,522,202,366,594,55
JHC,3,2022,1001,475,526,130,342,378,50
JHC,3,2022,1431,746,685,195,371,648,43
JHC,3,2022,2181,1102,1079,249,446,461,113
PLK,3,2022,1179,642,537,145,644,631,66
PLK,3,2022,1546,747,799,249,672,839,69
PLK,3,2022,3532,1976,1556,626,1952,1801,174
PLK,3,2022,982,533,449,135,644,608,41
PLK,3,2022,1606,837,769,242,228,507,82
PLK,3,2022,1073,606,467,105,124,1148,38
PLK,3,2022,1246,620,626,170,1938,3254,51
KVK,3,2022,1873,1007,866,219,935,656,78
KVK,3,2022,3350,1730,1620,394,793,706,144
KVK,3,2022,3059,1672,1387,414,368,226,150
ULK,3,2022,4304,2322,1982,507,390,443,233
ULK,3,2022,5355,2982,2373,674,1233,1752,238
ULK,3,2022,2947,1620,1327,444,375,271,160
ULK,3,2022,3601,1935,1666,357,361,779,194
ULK,3,2022,5011,2868,2143,604,266,163,283
ULK,3,2022,3842,2132,1710,485,445,489,217
ULK,3,2022,4526,2354,2172,505,388,411,201
LBK,3,2022,2222,1251,971,377,707,909,128
LBK,3,2022,2353,1271,1082,291,206,433,133
LBK,3,2022,4618,2457,2161,659,1706,2088,197
LBK,3,2022,1948,952,996,235,573,527,108
HKK,3,2022,3111,1576,1535,428,650,535,174
HKK,3,2022,1156,624,532,194,283,588,67
HKK,3,2022,2701,1313,1388,330,305,342,119
HKK,3,2022,963,550,413,164,304,369,39
HKK,3,2022,2552,1252,1300,335,468,260,128
PAK,3,2022,1946,962,984,289,463,481,103
PAK,3,2022,2852,1622,1230,466,1384,1858,152
PAK,3,2022,1948,910,1038,278,544,629,96
PAK,3,2022,1941,994,947,293,1294,776,80
VYS,3,2022,1703,948,755,218,330,377,87
VYS,3,2022,2095,1022,1073,275,710,651,101
VYS,3,2022,786,461,325,180,167,368,47
VYS,3,2022,2726,1392,1334,272,168,119,139
VYS,3,2022,2645,1269,1376,335,283,259,141
JHM,3,2022,2210,1106,1104,244,514,496,97
JHM,3,2022,12142,6338,5804,1178,2598,2292,609
JHM,3,2022,4323,2275,2048,495,1300,1144,223
JHM,3,2022,2631,1288,1343,314,424,749,127
JHM,3,2022,5563,2700,2863,518,822,701,292
JHM,3,2022,1496,801,695,200,554,476,77
JHM,3,2022,4221,2173,2048,434,549,284,199
OLK,3,2022,1404,662,742,146,107,63,46
OLK,3,2022,4652,2266,2386,755,1250,557,250
OLK,3,2022,1766,1035,731,277,304,361,63
OLK,3,2022,3619,1910,1709,424,470,381,181
OLK,3,2022,2830,1356,1474,376,606,403,124
ZLK,3,2022,1927,978,949,308,392,364,100
ZLK,3,2022,2591,1341,1250,351,680,938,120
ZLK,3,2022,3432,1559,1873,381,560,879,125
ZLK,3,2022,2736,1362,1374,410,1235,900,104
MSK,3,2022,3860,1938,1922,326,245,203,142
MSK,3,2022,4667,2127,2540,665,672,452,166
MSK,3,2022,13792,6443,7349,1074,502,384,381
MSK,3,2022,3121,1526,1595,372,1241,950,113
MSK,3,2022,3603,1705,1898,452,798,771,198
MSK,3,2022,12367,6434,5933,1331,1423,1298,596
PHA,4,2022,24028,12774,11254,3012,3047,7797,656
STC,4,2022,1209,668,541,235,186,225,46
STC,4,2022,2068,1081,987,274,253,298,112
STC,4,2022,5069,2721,2348,505,252,130,253
STC,4,2022,2700,1541,1159,389,263,253,145
STC,4,2022,1562,860,702,217,145,220,90
STC,4,2022,3177,1768,1409,363,374,416,148
STC,4,2022,1935,1088,847,288,424,1247,74
STC,4,2022,2596,1427,1169,342,177,436,113
STC,4,2022,1526,834,692,299,516,1638,71
STC,4,2022,1589,904,685,279,194,201,51
STC,4,2022,2887,1466,1421,360,205,375,155
STC,4,2022,1061,609,452,127,134,195,62
JHC,4,2022,2695,1439,1256,468,494,691,127
JHC,4,2022,1550,819,731,188,301,259,55
JHC,4,2022,1145,659,486,187,181,199,62
JHC,4,2022,1143,691,452,197,155,156,54
JHC,4,2022,903,459,444,131,85,200,52
JHC,4,2022,1260,701,559,197,140,207,43
JHC,4,2022,2039,1079,960,260,266,151,104
PLK,4,2022,1128,624,504,144,226,227,60
PLK,4,2022,1395,712,683,281,142,300,67
PLK,4,2022,3573,1989,1584,708,378,1946,168
PLK,4,2022,925,522,403,144,153,594,47
PLK,4,2022,1526,822,704,232,113,166,85
PLK,4,2022,1069,599,470,152,46,29,40
PLK,4,2022,1198,616,582,169,122,2928,46
KVK,4,2022,1713,922,791,231,325,407,69
KVK,4,2022,3218,1656,1562,352,237,310,138
KVK,4,2022,2957,1624,1333,342,77,142,139
ULK,4,2022,4172,2239,1933,588,124,108,220
ULK,4,2022,5373,2985,2388,594,235,748,246
ULK,4,2022,2831,1580,1251,376,186,288,155
ULK,4,2022,3544,1899,1645,392,143,104,181
ULK,4,2022,5024,2898,2126,522,129,219,274
ULK,4,2022,3878,2187,1691,522,218,341,216
ULK,4,2022,4474,2341,2133,469,246,263,204
LBK,4,2022,2247,1271,976,392,121,171,126
LBK,4,2022,2309,1263,1046,296,102,119,117
LBK,4,2022,4544,2446,2098,609,567,934,187
LBK,4,2022,1895,965,930,281,152,197,105
HKK,4,2022,2940,1521,1419,400,485,538,175
HKK,4,2022,1092,609,483,179,163,157,65
HKK,4,2022,2570,1295,1275,314,151,262,114
HKK,4,2022,920,532,388,140,191,239,37
HKK,4,2022,2462,1221,1241,352,234,160,125
PAK,4,2022,1702,941,761,282,209,195,96
PAK,4,2022,2751,1587,1164,447,349,520,149
PAK,4,2022,1775,885,890,265,328,212,96
PAK,4,2022,1894,1003,891,350,278,319,85
VYS,4,2022,1613,914,699,209,168,237,89
VYS,4,2022,1963,1021,942,342,250,440,113
VYS,4,2022,732,438,294,149,107,152,40
VYS,4,2022,2522,1337,1185,354,125,192,138
VYS,4,2022,2472,1229,1243,323,213,294,132
JHM,4,2022,2173,1097,1076,237,207,200,96
JHM,4,2022,12074,6326,5748,1171,1149,1016,605
JHM,4,2022,4239,2260,1979,530,380,380,217
JHM,4,2022,2315,1180,1135,320,197,283,114
JHM,4,2022,5234,2607,2627,465,584,703,270
JHM,4,2022,1425,774,651,189,219,370,82
JHM,4,2022,3831,2033,1798,398,537,433,193
OLK,4,2022,1229,610,619,149,30,42,41
OLK,4,2022,4343,2170,2173,668,507,661,222
OLK,4,2022,1746,1028,718,240,246,221,62
OLK,4,2022,3528,1889,1639,426,276,235,186
OLK,4,2022,2589,1329,1260,345,203,311,131
ZLK,4,2022,1864,966,898,307,249,311,106
ZLK,4,2022,2458,1288,1170,367,221,331,119
ZLK,4,2022,3220,1510,1710,374,326,296,126
ZLK,4,2022,2604,1319,1285,447,657,1174,106
MSK,4,2022,3636,1926,1710,379,197,187,143
MSK,4,2022,4459,2113,2346,608,328,335,164
MSK,4,2022,13621,6393,7228,1065,274,311,377
MSK,4,2022,2952,1516,1436,403,351,386,116
MSK,4,2022,3473,1739,1734,484,338,629,187
MSK,4,2022,12102,6359,5743,1256,673,485,592
PHA,5,2022,23728,12659,11069,3107,3821,3987,601
STC,5,2022,1199,688,511,233,232,172,44
STC,5,2022,2060,1077,983,256,147,171,111
STC,5,2022,5005,2721,2284,508,358,391,239
STC,5,2022,2566,1497,1069,359,499,295,134
STC,5,2022,1474,824,650,224,133,246,94
STC,5,2022,3129,1770,1359,416,467,263,137
STC,5,2022,1863,1059,804,254,440,792,64
STC,5,2022,2498,1388,1110,301,218,170,104
STC,5,2022,1516,840,676,273,467,914,70
STC,5,2022,1595,909,686,280,285,50,52
STC,5,2022,2828,1459,1369,384,196,844,147
STC,5,2022,987,575,412,133,123,127,60
JHC,5,2022,2659,1455,1204,513,624,564,119
JHC,5,2022,1422,773,649,197,208,414,52
JHC,5,2022,1054,619,435,194,153,170,54
JHC,5,2022,1087,661,426,196,285,151,53
JHC,5,2022,805,443,362,134,94,227,48
JHC,5,2022,1196,680,516,196,102,241,48
JHC,5,2022,1970,1086,884,298,214,305,110
PLK,5,2022,1129,615,514,164,203,167,65
PLK,5,2022,1245,658,587,214,200,141,59
PLK,5,2022,3522,2000,1522,590,458,738,158
PLK,5,2022,907,535,372,148,186,861,35
PLK,5,2022,1502,823,679,234,136,665,88
PLK,5,2022,1039,591,448,164,70,240,41
PLK,5,2022,1136,599,537,158,137,2430,44
KVK,5,2022,1639,899,740,246,253,352,70
KVK,5,2022,3100,1602,1498,358,324,365,136
KVK,5,2022,2865,1589,1276,345,192,184,139
ULK,5,2022,4063,2223,1840,562,180,158,210
ULK,5,2022,5263,2953,2310,551,286,713,237
ULK,5,2022,2515,1445,1070,379,337,276,140
ULK,5,2022,3338,1806,1532,340,247,188,169
ULK,5,2022,4980,2904,2076,560,299,141,268
ULK,5,2022,3748,2104,1644,489,163,182,215
ULK,5,2022,4482,2359,2123,484,295,404,209
LBK,5,2022,2040,1164,876,309,248,219,120
LBK,5,2022,2231,1278,953,293,173,164,115
LBK,5,2022,4447,2416,2031,618,764,902,177
LBK,5,2022,1775,947,828,226,118,176,103
HKK,5,2022,2831,1484,1347,400,630,539,163
HKK,5,2022,1066,608,458,211,158,212,62
HKK,5,2022,2417,1264,1153,330,182,211,105
HKK,5,2022,913,536,377,163,226,200,34
HKK,5,2022,2357,1205,1152,336,319,416,135
PAK,5,2022,1508,864,644,259,138,168,85
PAK,5,2022,2652,1540,1112,452,510,522,157
PAK,5,2022,1625,827,798,270,235,504,91
PAK,5,2022,1877,1024,853,360,674,499,86
VYS,5,2022,1516,878,638,197,250,195,79
VYS,5,2022,1860,980,880,301,380,418,113
VYS,5,2022,705,428,277,163,168,95,33
VYS,5,2022,2351,1276,1075,253,160,119,132
VYS,5,2022,2350,1189,1161,306,211,282,114
JHM,5,2022,2107,1084,1023,227,322,398,104
JHM,5,2022,11900,6278,5622,1172,1485,1725,595
JHM,5,2022,4147,2248,1899,517,609,931,220
JHM,5,2022,2194,1124,1070,348,357,344,120
JHM,5,2022,4950,2526,2424,489,433,301,255
JHM,5,2022,1389,762,627,216,366,356,73
JHM,5,2022,3502,1874,1628,387,186,223,186
OLK,5,2022,1095,561,534,137,40,57,34
OLK,5,2022,4209,2124,2085,670,606,664,233
OLK,5,2022,1660,991,669,228,181,166,61
OLK,5,2022,3415,1892,1523,375,266,212,183
OLK,5,2022,2410,1253,1157,358,181,227,118
ZLK,5,2022,1791,939,852,309,233,195,96
ZLK,5,2022,2382,1304,1078,363,246,263,108
ZLK,5,2022,3009,1460,1549,353,315,388,107
ZLK,5,2022,2522,1278,1244,420,458,692,103
MSK,5,2022,3404,1868,1536,341,193,135,143
MSK,5,2022,4292,2075,2217,628,366,309,163
MSK,5,2022,13489,6350,7139,1102,269,286,385
MSK,5,2022,2781,1455,1326,420,397,730,107
MSK,5,2022,3315,1706,1609,430,309,362,189
MSK,5,2022,11870,6269,5601,1302,720,629,563
PHA,6,2022,23550,12674,10876,3177,3611,14609,522
STC,6,2022,1181,684,497,240,204,176,44
STC,6,2022,2088,1107,981,238,141,93,99
STC,6,2022,4976,2729,2247,490,271,653,215
STC,6,2022,2570,1520,1050,423,255,650,111
STC,6,2022,1465,841,624,224,100,204,72
STC,6,2022,3109,1784,1325,402,346,188,109
STC,6,2022,1820,1051,769,256,491,637,63
STC,6,2022,2424,1338,1086,300,177,302,94
STC,6,2022,1526,859,667,308,570,2190,51
STC,6,2022,1608,928,680,262,198,125,49
STC,6,2022,2763,1449,1314,395,217,228,124
STC,6,2022,947,558,389,164,107,122,56
JHC,6,2022,2712,1518,1194,515,563,515,109
JHC,6,2022,1373,739,634,199,238,386,40
JHC,6,2022,999,587,412,187,133,124,40
JHC,6,2022,1017,622,395,171,193,274,39
JHC,6,2022,812,449,363,160,148,112,38
JHC,6,2022,1209,689,520,197,122,131,51
JHC,6,2022,1943,1101,842,291,194,222,101
PLK,6,2022,1078,608,470,131,101,214,54
PLK,6,2022,1256,683,573,246,212,168,56
PLK,6,2022,3504,2023,1481,577,518,470,130
PLK,6,2022,915,533,382,150,192,327,33
PLK,6,2022,1505,834,671,193,105,95,75
PLK,6,2022,1015,584,431,127,50,105,36
PLK,6,2022,1111,597,514,162,128,1291,37
KVK,6,2022,1491,811,680,217,297,323,66
KVK,6,2022,2929,1542,1387,318,243,401,110
KVK,6,2022,2744,1542,1202,306,88,91,125
ULK,6,2022,3904,2175,1729,476,127,278,164
ULK,6,2022,5007,2816,2191,526,223,298,187
ULK,6,2022,2468,1454,1014,401,136,231,103
ULK,6,2022,3203,1777,1426,329,187,134,145
ULK,6,2022,4866,2863,2003,522,199,199,218
ULK,6,2022,3636,2051,1585,503,194,357,174
ULK,6,2022,4375,2328,2047,450,214,323,176
LBK,6,2022,2053,1162,891,343,243,247,103
LBK,6,2022,2204,1276,928,289,105,170,104
LBK,6,2022,4384,2426,1958,665,459,1000,165
LBK,6,2022,1703,930,773,205,177,173,79
HKK,6,2022,2832,1520,1312,437,522,734,142
HKK,6,2022,1049,603,446,196,198,155,53
HKK,6,2022,2350,1269,1081,338,173,178,101
HKK,6,2022,900,545,355,166,188,247,30
HKK,6,2022,2265,1181,1084,295,322,275,112
PAK,6,2022,1459,853,606,281,143,280,67
PAK,6,2022,2670,1557,1113,486,418,464,137
PAK,6,2022,1589,812,777,264,246,286,83
PAK,6,2022,1884,1028,856,347,342,296,70
VYS,6,2022,1505,881,624,191,124,202,64
VYS,6,2022,1851,983,868,321,270,276,98
VYS,6,2022,729,442,287,185,130,133,25
VYS,6,2022,2253,1239,1014,291,109,149,118
VYS,6,2022,2258,1166,1092,264,222,449,84
JHM,6,2022,2106,1111,995,255,216,294,82
JHM,6,2022,11954,6356,5598,1256,1551,1119,509
JHM,6,2022,4202,2300,1902,589,453,426,170
JHM,6,2022,2166,1150,1016,325,346,205,88
JHM,6,2022,4746,2468,2278,470,364,485,182
JHM,6,2022,1385,771,614,198,238,155,59
JHM,6,2022,3318,1804,1514,414,195,231,136
OLK,6,2022,966,481,485,116,54,93,19
OLK,6,2022,4166,2138,2028,693,654,709,215
OLK,6,2022,1597,963,634,254,175,302,44
OLK,6,2022,3401,1920,1481,427,158,264,151
OLK,6,2022,2347,1230,1117,342,218,209,93
ZLK,6,2022,1722,912,810,268,227,271,69
ZLK,6,2022,2362,1313,1049,370,215,279,105
ZLK,6,2022,2938,1461,1477,404,390,589,90
ZLK,6,2022,2495,1299,1196,447,657,579,85
MSK,6,2022,3323,1855,1468,360,161,182,120
MSK,6,2022,4178,2051,2127,585,256,242,133
MSK,6,2022,13212,6266,6946,1025,216,248,340
MSK,6,2022,2796,1484,1312,474,433,728,109
MSK,6,2022,3220,1669,1551,434,266,390,163
MSK,6,2022,11672,6212,5460,1348,460,750,486
PHA,7,2022,24989,13677,11312,3851,2708,4128,563
STC,7,2022,1215,718,497,237,169,162,30
STC,7,2022,2205,1198,1007,318,134,181,96
STC,7,2022,5063,2821,2242,540,233,98,225
STC,7,2022,2730,1615,1115,466,226,299,109
STC,7,2022,1573,905,668,287,85,230,74
STC,7,2022,3221,1877,1344,410,185,300,110
STC,7,2022,1974,1160,814,336,510,455,66
STC,7,2022,2510,1391,1119,331,117,91,107
STC,7,2022,1644,959,685,345,372,734,58
STC,7,2022,1673,961,712,287,199,253,47
STC,7,2022,2970,1612,1358,491,143,758,131
STC,7,2022,995,594,401,170,176,94,55
JHC,7,2022,2987,1718,1269,646,372,403,140
JHC,7,2022,1372,763,609,204,200,122,51
JHC,7,2022,1046,622,424,207,82,163,45
JHC,7,2022,1038,634,404,213,66,155,45
JHC,7,2022,811,458,353,132,120,166,41
JHC,7,2022,1288,749,539,216,73,158,59
JHC,7,2022,2032,1172,860,317,106,138,104
PLK,7,2022,1049,599,450,114,58,98,49
PLK,7,2022,1332,741,591,271,99,224,63
PLK,7,2022,3690,2161,1529,614,508,972,147
PLK,7,2022,948,562,386,172,102,91,43
PLK,7,2022,1575,877,698,243,49,26,70
PLK,7,2022,1060,615,445,148,327,94,37
PLK,7,2022,1176,634,542,187,148,215,38
KVK,7,2022,1541,845,696,287,273,292,70
KVK,7,2022,2983,1612,1371,409,259,244,105
KVK,7,2022,2703,1539,1164,292,71,51,130
ULK,7,2022,3974,2257,1717,503,52,86,161
ULK,7,2022,5102,2907,2195,593,132,556,205
ULK,7,2022,2636,1577,1059,475,113,138,126
ULK,7,2022,3254,1859,1395,377,181,106,145
ULK,7,2022,4904,2893,2011,532,90,161,195
ULK,7,2022,3730,2139,1591,472,149,136,168
ULK,7,2022,4450,2426,2024,510,173,139,176
LBK,7,2022,2077,1204,873,326,120,164,105
LBK,7,2022,2272,1333,939,322,57,86,99
LBK,7,2022,4573,2578,1995,667,342,458,151
LBK,7,2022,1759,986,773,246,100,66,85
HKK,7,2022,3010,1664,1346,499,353,356,163
HKK,7,2022,1106,662,444,226,79,149,58
HKK,7,2022,2456,1337,1119,376,157,140,104
HKK,7,2022,958,605,353,194,212,114,29
HKK,7,2022,2388,1267,1121,363,183,291,105
PAK,7,2022,1587,937,650,365,99,109,76
PAK,7,2022,2896,1728,1168,583,386,1072,137
PAK,7,2022,1751,926,825,379,163,124,93
PAK,7,2022,1999,1117,882,365,280,353,86
VYS,7,2022,1657,985,672,317,97,125,82
VYS,7,2022,1994,1075,919,359,272,306,101
VYS,7,2022,765,479,286,178,140,555,32
VYS,7,2022,2353,1333,1020,344,81,69,121
VYS,7,2022,2394,1290,1104,383,86,105,91
JHM,7,2022,2196,1173,1023,307,102,177,85
JHM,7,2022,12490,6765,5725,1444,771,904,543
JHM,7,2022,4440,2494,1946,648,330,408,190
JHM,7,2022,2225,1209,1016,379,198,294,93
JHM,7,2022,4890,2609,2281,577,286,456,188
JHM,7,2022,1485,843,642,255,125,122,63
JHM,7,2022,3362,1858,1504,448,125,164,142
OLK,7,2022,1001,512,489,157,36,10,24
OLK,7,2022,4376,2308,2068,749,340,415,229
OLK,7,2022,1691,1045,646,330,103,47,47
OLK,7,2022,3493,1994,1499,419,142,131,154
OLK,7,2022,2400,1286,1114,349,93,88,100
ZLK,7,2022,1824,982,842,321,120,146,91
ZLK,7,2022,2497,1417,1080,398,95,217,120
ZLK,7,2022,3062,1592,1470,455,193,232,113
ZLK,7,2022,2617,1416,1201,495,281,637,90
MSK,7,2022,3427,1935,1492,385,113,91,114
MSK,7,2022,4356,2165,2191,654,238,285,138
MSK,7,2022,13310,6430,6880,1086,193,171,352
MSK,7,2022,2932,1593,1339,457,500,248,106
MSK,7,2022,3369,1803,1566,507,217,283,163
MSK,7,2022,11825,6384,5441,1331,364,505,499
PHA,8,2022,27326,15712,11614,5543,3397,3494,625
STC,8,2022,1268,742,526,319,215,189,43
STC,8,2022,2321,1302,1019,391,175,114,100
STC,8,2022,5187,2940,2247,674,575,220,241
STC,8,2022,3036,1823,1213,634,450,366,142
STC,8,2022,1680,1010,670,350,100,149,82
STC,8,2022,3370,1967,1403,517,144,162,122
STC,8,2022,2092,1249,843,395,477,511,62
STC,8,2022,2771,1594,1177,510,263,165,120
STC,8,2022,1860,1131,729,504,582,302,63
STC,8,2022,1871,1148,723,477,345,509,51
STC,8,2022,3147,1758,1389,521,151,239,151
STC,8,2022,1054,638,416,208,143,62,61
JHC,8,2022,3138,1862,1276,729,336,619,148
JHC,8,2022,1431,795,636,262,102,63,54
JHC,8,2022,1110,674,436,263,147,115,54
JHC,8,2022,1132,697,435,281,95,98,42
JHC,8,2022,843,475,368,170,113,101,50
JHC,8,2022,1347,814,533,247,196,165,51
JHC,8,2022,2157,1287,870,383,193,252,124
PLK,8,2022,1073,626,447,145,85,48,62
PLK,8,2022,1403,817,586,300,243,285,71
PLK,8,2022,3772,2190,1582,635,504,589,162
PLK,8,2022,948,572,376,167,107,269,50
PLK,8,2022,1608,894,714,214,140,246,79
PLK,8,2022,1110,657,453,198,86,55,47
PLK,8,2022,1240,675,565,212,395,288,48
KVK,8,2022,1624,918,706,345,348,211,63
KVK,8,2022,3232,1847,1385,640,243,321,105
KVK,8,2022,2736,1576,1160,408,83,114,123
ULK,8,2022,4096,2376,1720,636,178,152,184
ULK,8,2022,5151,2946,2205,615,330,237,214
ULK,8,2022,2804,1688,1116,567,168,159,125
ULK,8,2022,3363,1930,1433,486,137,119,157
ULK,8,2022,4992,2976,2016,656,137,86,193
ULK,8,2022,3790,2237,1553,607,143,250,155
ULK,8,2022,4585,2559,2026,634,119,161,166
LBK,8,2022,2127,1232,895,364,150,231,112
LBK,8,2022,2346,1417,929,375,85,91,109
LBK,8,2022,4779,2780,1999,854,484,374,150
LBK,8,2022,1859,1060,799,314,178,259,92
HKK,8,2022,3215,1822,1393,604,583,473,197
HKK,8,2022,1195,723,472,274,167,100,77
HKK,8,2022,2552,1431,1121,453,161,372,113
HKK,8,2022,1004,631,373,227,205,360,30
HKK,8,2022,2481,1360,1121,377,266,170,113
PAK,8,2022,1651,992,659,360,161,176,95
PAK,8,2022,3083,1858,1225,696,614,756,155
PAK,8,2022,1852,978,874,353,134,173,110
PAK,8,2022,2109,1193,916,425,234,241,103
VYS,8,2022,1711,1038,673,266,133,150,94
VYS,8,2022,2109,1175,934,420,282,577,128
VYS,8,2022,822,504,318,214,167,201,51
VYS,8,2022,2425,1390,1035,369,93,56,123
VYS,8,2022,2514,1367,1147,397,211,213,129
JHM,8,2022,2323,1262,1061,379,190,245,109
JHM,8,2022,13115,7232,5883,1851,1185,1046,614
JHM,8,2022,4593,2593,2000,707,403,463,206
JHM,8,2022,2363,1300,1063,447,247,599,107
JHM,8,2022,5009,2699,2310,619,275,355,233
JHM,8,2022,1577,897,680,302,200,199,80
JHM,8,2022,3519,1968,1551,593,150,126,173
OLK,8,2022,1021,534,487,156,60,59,26
OLK,8,2022,4606,2516,2090,967,730,624,245
OLK,8,2022,1741,1085,656,307,88,262,44
OLK,8,2022,3595,2092,1503,520,138,279,178
OLK,8,2022,2554,1381,1173,503,166,185,120
ZLK,8,2022,1918,1061,857,377,146,201,103
ZLK,8,2022,2597,1490,1107,454,131,232,146
ZLK,8,2022,3132,1640,1492,461,255,279,132
ZLK,8,2022,2730,1533,1197,600,453,400,106
MSK,8,2022,3462,2003,1459,391,127,160,120
MSK,8,2022,4571,2334,2237,787,267,259,163
MSK,8,2022,13458,6555,6903,1240,254,178,346
MSK,8,2022,3025,1663,1362,480,519,360,120
MSK,8,2022,3441,1857,1584,553,274,220,173
MSK,8,2022,11901,6494,5407,1445,601,546,505
PHA,9,2022,27809,16042,11767,4973,3098,4667,815
STC,9,2022,1360,784,576,431,173,309,97
STC,9,2022,2332,1286,1046,415,256,159,116
STC,9,2022,5306,2995,2311,830,284,174,347
STC,9,2022,3053,1815,1238,628,270,281,212
STC,9,2022,1712,1003,709,379,210,203,113
STC,9,2022,3483,2039,1444,631,134,216,195
STC,9,2022,2134,1286,848,414,423,652,108
STC,9,2022,2827,1592,1235,543,183,114,198
STC,9,2022,1960,1167,793,507,565,562,116
STC,9,2022,1918,1134,784,464,285,121,87
STC,9,2022,3180,1732,1448,651,168,327,224
STC,9,2022,1088,638,450,272,78,39,100
JHC,9,2022,3195,1894,1301,761,599,441,196
JHC,9,2022,1484,815,669,304,92,77,85
JHC,9,2022,1234,735,499,344,91,167,104
JHC,9,2022,1187,712,475,356,77,153,96
JHC,9,2022,896,493,403,234,116,148,72
JHC,9,2022,1374,830,544,322,125,202,73
JHC,9,2022,2099,1232,867,414,153,206,147
PLK,9,2022,1065,612,453,207,84,182,87
PLK,9,2022,1427,808,619,359,202,361,125
PLK,9,2022,3765,2198,1567,842,517,568,183
PLK,9,2022,956,560,396,222,90,113,62
PLK,9,2022,1628,889,739,334,291,79,119
PLK,9,2022,1104,641,463,199,39,50,71
PLK,9,2022,1267,671,596,248,130,176,87
KVK,9,2022,1735,983,752,435,257,298,101
KVK,9,2022,3300,1850,1450,612,194,172,158
KVK,9,2022,2871,1630,1241,549,80,60,209
ULK,9,2022,4280,2435,1845,850,94,124,275
ULK,9,2022,5220,2960,2260,795,435,175,290
ULK,9,2022,2798,1661,1137,580,208,188,196
ULK,9,2022,3368,1921,1447,505,104,141,219
ULK,9,2022,5013,2963,2050,724,92,161,304
ULK,9,2022,3933,2321,1612,755,171,126,270
ULK,9,2022,4686,2608,2078,723,175,107,258
LBK,9,2022,2323,1343,980,578,202,269,192
LBK,9,2022,2427,1478,949,506,132,113,153
LBK,9,2022,4842,2816,2026,926,538,553,216
LBK,9,2022,1813,1027,786,340,174,202,108
HKK,9,2022,3206,1817,1389,668,464,407,227
HKK,9,2022,1262,747,515,378,148,124,120
HKK,9,2022,2651,1491,1160,598,223,154,162
HKK,9,2022,1006,613,393,284,127,177,65
HKK,9,2022,2572,1389,1183,567,223,340,214
PAK,9,2022,1744,1011,733,512,140,258,187
PAK,9,2022,3166,1874,1292,784,353,409,228
PAK,9,2022,1895,1015,880,450,168,163,161
PAK,9,2022,2137,1164,973,526,249,410,154
VYS,9,2022,1761,1058,703,381,253,154,122
VYS,9,2022,2080,1157,923,502,282,330,173
VYS,9,2022,854,501,353,266,106,196,81
VYS,9,2022,2497,1403,1094,546,120,196,221
VYS,9,2022,2504,1376,1128,487,156,116,182
JHM,9,2022,2404,1323,1081,451,135,164,156
JHM,9,2022,13114,7114,6000,1865,1296,4462,664
JHM,9,2022,4522,2516,2006,810,339,360,270
JHM,9,2022,2404,1270,1134,555,184,175,185
JHM,9,2022,5130,2728,2402,847,217,219,346
JHM,9,2022,1607,882,725,344,215,285,121
JHM,9,2022,3592,1966,1626,685,214,156,283
OLK,9,2022,1075,572,503,224,31,92,61
OLK,9,2022,4691,2491,2200,1084,386,453,367
OLK,9,2022,1752,1065,687,408,133,356,89
OLK,9,2022,3606,2049,1557,633,161,171,268
OLK,9,2022,2567,1375,1192,558,152,271,188
ZLK,9,2022,1987,1083,904,463,180,163,157
ZLK,9,2022,2711,1528,1183,602,142,245,213
ZLK,9,2022,3153,1622,1531,615,247,245,214
ZLK,9,2022,2782,1539,1243,720,417,264,201
MSK,9,2022,3479,2002,1477,497,126,184,199
MSK,9,2022,4754,2409,2345,1007,193,241,288
MSK,9,2022,13631,6622,7009,1560,185,300,534
MSK,9,2022,3068,1671,1397,666,416,338,195
MSK,9,2022,3553,1838,1715,750,212,343,287
MSK,9,2022,12011,6479,5532,1885,468,522,723
PHA,10,2022,27914,16046,11868,4250,3102,3526,881
STC,10,2022,1365,777,588,278,195,213,94
STC,10,2022,2353,1288,1065,345,141,93,127
STC,10,2022,5265,2948,2317,592,296,433,325
STC,10,2022,2971,1743,1228,464,203,258,210
STC,10,2022,1712,1011,701,287,103,114,116
STC,10,2022,3521,2050,1471,523,234,91,207
STC,10,2022,2211,1313,898,404,516,151,121
STC,10,2022,2814,1575,1239,405,146,84,179
STC,10,2022,1968,1157,811,384,434,830,115
STC,10,2022,1878,1095,783,295,247,373,89
STC,10,2022,3169,1708,1461,470,155,136,215
STC,10,2022,1051,629,422,160,170,383,85
JHC,10,2022,3181,1884,1297,620,322,495,191
JHC,10,2022,1530,843,687,320,192,173,87
JHC,10,2022,1280,758,522,305,115,174,106
JHC,10,2022,1179,728,451,239,130,113,100
JHC,10,2022,909,496,413,171,84,88,71
JHC,10,2022,1393,837,556,239,108,140,67
JHC,10,2022,2046,1181,865,344,245,248,147
PLK,10,2022,1026,584,442,149,70,148,83
PLK,10,2022,1420,797,623,300,176,263,112
PLK,10,2022,3697,2153,1544,717,366,613,199
PLK,10,2022,926,533,393,172,114,41,58
PLK,10,2022,1678,912,766,303,66,52,115
PLK,10,2022,1061,617,444,121,48,137,54
PLK,10,2022,1229,662,567,193,98,118,81
KVK,10,2022,1757,1016,741,354,256,918,115
KVK,10,2022,3378,1909,1469,494,214,307,185
KVK,10,2022,2857,1621,1236,421,81,80,197
ULK,10,2022,4326,2467,1859,588,106,174,294
ULK,10,2022,5155,2953,2202,616,189,156,288
ULK,10,2022,2749,1639,1110,418,112,161,186
ULK,10,2022,3364,1907,1457,412,273,167,220
ULK,10,2022,5038,2947,2091,656,115,91,333
ULK,10,2022,4003,2347,1656,619,135,207,273
ULK,10,2022,4720,2632,2088,597,198,121,255
LBK,10,2022,2410,1402,1008,493,243,145,205
LBK,10,2022,2428,1468,960,406,145,128,157
LBK,10,2022,4880,2840,2040,764,445,511,244
LBK,10,2022,1838,1031,807,273,133,191,102
HKK,10,2022,3303,1861,1442,578,358,661,224
HKK,10,2022,1197,697,500,231,114,174,119
HKK,10,2022,2698,1504,1194,472,187,161,153
HKK,10,2022,991,581,410,198,127,131,52
HKK,10,2022,2502,1348,1154,355,249,368,189
PAK,10,2022,1721,997,724,324,129,311,180
PAK,10,2022,3168,1879,1289,588,481,798,209
PAK,10,2022,1849,1000,849,302,178,367,146
PAK,10,2022,2126,1161,965,405,196,245,146
VYS,10,2022,1718,1012,706,264,86,152,123
VYS,10,2022,2036,1122,914,350,261,247,162
VYS,10,2022,828,500,328,179,102,48,75
VYS,10,2022,2447,1371,1076,324,101,94,195
VYS,10,2022,2421,1313,1108,321,104,398,157
JHM,10,2022,2389,1293,1096,308,168,191,157
JHM,10,2022,13117,7102,6015,1464,1163,5216,649
JHM,10,2022,4429,2461,1968,603,483,484,256
JHM,10,2022,2428,1277,1151,455,259,191,171
JHM,10,2022,5073,2692,2381,587,310,398,341
JHM,10,2022,1617,897,720,250,195,195,114
JHM,10,2022,3637,2007,1630,557,113,176,251
OLK,10,2022,1120,603,517,204,53,100,63
OLK,10,2022,4718,2496,2222,849,409,515,361
OLK,10,2022,1745,1059,686,315,131,132,78
OLK,10,2022,3566,2016,1550,446,172,112,247
OLK,10,2022,2617,1396,1221,445,137,260,166
ZLK,10,2022,1977,1059,918,359,85,191,144
ZLK,10,2022,2738,1558,1180,446,209,260,196
ZLK,10,2022,3098,1598,1500,443,226,386,184
ZLK,10,2022,2704,1467,1237,507,242,356,176
MSK,10,2022,3496,2011,1485,415,154,142,197
MSK,10,2022,4730,2376,2354,711,197,322,248
MSK,10,2022,13503,6529,6974,1174,212,174,530
MSK,10,2022,3033,1653,1380,490,324,527,169
MSK,10,2022,3549,1833,1716,569,218,241,264
MSK,10,2022,11853,6356,5497,1512,559,582,736
PHA,11,2022,27625,15740,11885,3754,2458,1450,843
STC,11,2022,1365,783,582,282,160,227,87
STC,11,2022,2308,1270,1038,278,157,120,124
STC,11,2022,5202,2875,2327,554,187,97,299
STC,11,2022,2975,1754,1221,475,262,303,185
STC,11,2022,1740,1014,726,284,101,206,108
STC,11,2022,3517,2023,1494,471,121,42,195
STC,11,2022,2164,1274,890,286,288,126,94
STC,11,2022,2833,1548,1285,395,192,267,165
STC,11,2022,1947,1156,791,360,512,297,95
STC,11,2022,1799,1021,778,287,337,36,74
STC,11,2022,3176,1685,1491,442,184,118,179
STC,11,2022,1019,606,413,162,133,181,73
JHC,11,2022,3142,1802,1340,587,349,490,177
JHC,11,2022,1651,897,754,347,185,624,82
JHC,11,2022,1387,802,585,337,51,143,94
JHC,11,2022,1201,722,479,237,79,123,84
JHC,11,2022,951,498,453,214,184,192,53
JHC,11,2022,1422,835,587,237,92,168,65
JHC,11,2022,2039,1146,893,318,162,255,131
PLK,11,2022,1035,597,438,168,207,219,71
PLK,11,2022,1556,844,712,405,159,362,109
PLK,11,2022,3643,2086,1557,674,684,686,171
PLK,11,2022,947,546,401,191,96,137,51
PLK,11,2022,1737,926,811,268,266,71,105
PLK,11,2022,1093,627,466,172,92,112,47
PLK,11,2022,1193,635,558,181,153,119,74
KVK,11,2022,1761,1014,747,305,239,245,91
KVK,11,2022,3427,1936,1491,507,264,197,166
KVK,11,2022,2875,1614,1261,385,107,107,192
ULK,11,2022,4364,2471,1893,650,88,120,270
ULK,11,2022,5155,2928,2227,582,213,381,267
ULK,11,2022,2786,1623,1163,493,159,206,164
ULK,11,2022,3379,1872,1507,423,57,110,200
ULK,11,2022,5011,2916,2095,575,76,81,316
ULK,11,2022,3950,2318,1632,517,142,187,244
ULK,11,2022,4716,2611,2105,564,234,159,247
LBK,11,2022,2392,1384,1008,429,145,208,178
LBK,11,2022,2490,1495,995,372,110,198,139
LBK,11,2022,4930,2820,2110,776,454,673,240
LBK,11,2022,1900,1054,846,309,155,144,100
HKK,11,2022,3320,1817,1503,546,362,358,205
HKK,11,2022,1243,717,526,254,105,91,107
HKK,11,2022,2795,1530,1265,462,149,170,143
HKK,11,2022,1000,574,426,188,153,137,48
HKK,11,2022,2586,1376,1210,403,256,360,166
PAK,11,2022,1795,1037,758,384,135,124,141
PAK,11,2022,3138,1840,1298,536,321,428,177
PAK,11,2022,1943,1023,920,363,168,240,132
PAK,11,2022,2143,1153,990,423,281,309,118
VYS,11,2022,1722,1011,711,264,74,122,121
VYS,11,2022,2107,1144,963,433,419,380,157
VYS,11,2022,795,484,311,177,91,114,63
VYS,11,2022,2484,1385,1099,390,109,84,162
VYS,11,2022,2416,1292,1124,371,122,123,133
JHM,11,2022,2393,1270,1123,318,145,132,131
JHM,11,2022,12998,7036,5962,1290,959,3831,611
JHM,11,2022,4416,2443,1973,612,296,424,226
JHM,11,2022,2568,1345,1223,535,487,500,150
JHM,11,2022,5210,2748,2462,681,273,245,314
JHM,11,2022,1607,884,723,249,111,171,89
JHM,11,2022,3897,2208,1689,726,84,150,229
OLK,11,2022,1229,642,587,264,65,42,65
OLK,11,2022,4733,2481,2252,860,393,643,309
OLK,11,2022,1768,1063,705,334,69,155,78
OLK,11,2022,3565,2011,1554,478,154,378,225
OLK,11,2022,2728,1402,1326,502,150,286,157
ZLK,11,2022,1953,1054,899,323,146,260,116
ZLK,11,2022,2773,1548,1225,418,156,270,179
ZLK,11,2022,3225,1624,1601,509,182,399,162
ZLK,11,2022,2650,1408,1242,491,303,686,142
MSK,11,2022,3613,2049,1564,461,111,150,190
MSK,11,2022,4766,2332,2434,733,155,290,238
MSK,11,2022,13402,6459,6943,1168,175,244,465
MSK,11,2022,3060,1623,1437,556,297,452,143
MSK,11,2022,3602,1839,1763,564,250,414,245
MSK,11,2022,11741,6284,5457,1408,469,510,684
PHA,12,2022,27766,15747,12019,3131,2270,1350,779
STC,12,2022,1414,794,620,287,142,94,75
STC,12,2022,2383,1276,1107,313,110,118,129
STC,12,2022,5278,2876,2402,511,151,373,273
STC,12,2022,3122,1783,1339,480,142,167,174
STC,12,2022,1882,1050,832,335,89,39,100
STC,12,2022,3661,2087,1574,463,98,178,172
STC,12,2022,2186,1298,888,285,266,222,87
STC,12,2022,2917,1560,1357,367,183,226,165
STC,12,2022,2030,1206,824,333,279,174,81
STC,12,2022,1795,1008,787,265,194,325,74
STC,12,2022,3430,1745,1685,582,123,377,163
STC,12,2022,1079,630,449,173,69,100,67
JHC,12,2022,3351,1855,1496,645,222,430,166
JHC,12,2022,1884,937,947,408,87,45,85
JHC,12,2022,1624,842,782,441,108,159,84
JHC,12,2022,1332,774,558,290,101,142,85
JHC,12,2022,1104,521,583,284,53,67,50
JHC,12,2022,1640,889,751,371,69,110,72
JHC,12,2022,2195,1138,1057,423,71,130,133
PLK,12,2022,1074,592,482,185,117,149,62
PLK,12,2022,1836,913,923,494,64,138,95
PLK,12,2022,3762,2123,1639,607,573,261,174
PLK,12,2022,983,544,439,165,34,74,54
PLK,12,2022,1846,964,882,269,65,31,96
PLK,12,2022,1184,684,500,199,43,27,43
PLK,12,2022,1285,658,627,224,118,348,63
KVK,12,2022,1908,1088,820,362,181,166,86
KVK,12,2022,3533,1950,1583,450,172,119,154
KVK,12,2022,2988,1643,1345,429,72,69,178
ULK,12,2022,4633,2552,2081,676,56,172,263
ULK,12,2022,5341,3013,2328,648,188,136,260
ULK,12,2022,3152,1797,1355,674,121,161,170
ULK,12,2022,3607,1972,1635,490,120,167,195
ULK,12,2022,5082,2969,2113,490,72,121,293
ULK,12,2022,4128,2395,1733,554,71,109,223
ULK,12,2022,4797,2632,2165,471,167,196,245
LBK,12,2022,2532,1461,1071,411,210,163,159
LBK,12,2022,2568,1510,1058,327,87,73,135
LBK,12,2022,5114,2835,2279,720,338,387,212
LBK,12,2022,2041,1062,979,348,103,100,105
HKK,12,2022,3466,1853,1613,521,258,353,185
HKK,12,2022,1299,707,592,227,63,128,94
HKK,12,2022,3053,1585,1468,512,105,255,141
HKK,12,2022,1036,588,448,185,134,78,56
HKK,12,2022,2715,1377,1338,410,122,163,157
PAK,12,2022,2128,1072,1056,544,65,120,133
PAK,12,2022,3318,1920,1398,553,276,457,175
PAK,12,2022,2297,1119,1178,543,79,106,134
PAK,12,2022,2262,1151,1111,389,305,526,103
VYS,12,2022,1861,1014,847,330,75,114,107
VYS,12,2022,2385,1174,1211,563,179,288,140
VYS,12,2022,885,515,370,225,126,132,59
VYS,12,2022,2879,1475,1404,609,56,113,159
VYS,12,2022,2678,1331,1347,525,98,146,138
JHM,12,2022,2577,1320,1257,358,97,127,143
JHM,12,2022,13304,7188,6116,1245,904,829,591
JHM,12,2022,4580,2487,2093,578,198,322,218
JHM,12,2022,2994,1502,1492,707,123,135,149
JHM,12,2022,5753,2870,2883,946,170,218,316
JHM,12,2022,1722,898,824,285,92,119,101
JHM,12,2022,4475,2384,2091,905,96,95,242
OLK,12,2022,1514,756,758,379,22,44,62
OLK,12,2022,5082,2497,2585,955,282,769,277
OLK,12,2022,1878,1105,773,306,77,55,79
OLK,12,2022,3795,2045,1750,540,120,134,217
OLK,12,2022,3028,1477,1551,583,103,185,157
ZLK,12,2022,2147,1112,1035,398,66,133,114
ZLK,12,2022,3029,1612,1417,517,94,225,176
ZLK,12,2022,3466,1639,1827,582,256,406,170
ZLK,12,2022,2828,1450,1378,552,174,347,141
MSK,12,2022,4131,2131,2000,773,98,93,183
MSK,12,2022,5078,2421,2657,795,106,133,234
MSK,12,2022,13673,6541,7132,1133,76,185,450
MSK,12,2022,3272,1637,1635,544,258,642,136
MSK,12,2022,3839,1852,1987,658,150,138,241
MSK,12,2022,11909,6290,5619,1301,314,633,654
PHA,1,2023,28199,15992,12207,4478,3345,4813,763
STC,1,2023,1501,822,679,376,228,221,66
STC,1,2023,2503,1332,1171,421,174,180,126
STC,1,2023,5372,2910,2462,746,415,365,272
STC,1,2023,3185,1781,1404,549,294,260,165
STC,1,2023,1989,1077,912,361,186,119,98
STC,1,2023,3719,2093,1626,556,199,116,162
STC,1,2023,2249,1345,904,395,448,1131,84
STC,1,2023,3026,1642,1384,493,292,546,171
STC,1,2023,2048,1206,842,412,627,1273,78
STC,1,2023,1836,1025,811,342,395,66,69
STC,1,2023,3648,1815,1833,684,163,312,148
STC,1,2023,1177,665,512,264,128,207,63
JHC,1,2023,3559,1928,1631,843,401,666,161
JHC,1,2023,2095,995,1100,487,385,660,78
JHC,1,2023,1921,930,991,561,155,219,79
JHC,1,2023,1478,833,645,374,247,229,85
JHC,1,2023,1203,545,658,303,152,124,51
JHC,1,2023,1729,876,853,338,129,91,70
JHC,1,2023,2347,1181,1166,543,132,898,132
PLK,1,2023,1142,604,538,269,103,99,54
PLK,1,2023,2009,968,1041,496,114,182,92
PLK,1,2023,3933,2211,1722,818,776,2371,163
PLK,1,2023,1046,558,488,242,280,153,47
PLK,1,2023,1912,976,936,343,134,292,93
PLK,1,2023,1220,688,532,197,98,120,46
PLK,1,2023,1353,681,672,276,109,462,58
KVK,1,2023,2099,1178,921,463,508,320,83
KVK,1,2023,3668,1994,1674,582,279,198,164
KVK,1,2023,3070,1646,1424,544,109,94,189
ULK,1,2023,4972,2669,2303,864,199,193,253
ULK,1,2023,5472,3095,2377,768,197,879,265
ULK,1,2023,3261,1813,1448,585,219,267,167
ULK,1,2023,3747,2022,1725,528,186,246,185
ULK,1,2023,5218,3069,2149,707,109,143,279
ULK,1,2023,4301,2455,1846,731,193,232,237
ULK,1,2023,4923,2695,2228,665,141,144,238
LBK,1,2023,2613,1463,1150,479,524,283,141
LBK,1,2023,2645,1517,1128,456,84,118,136
LBK,1,2023,5302,2886,2416,948,810,1015,202
LBK,1,2023,2127,1054,1073,385,251,170,99
HKK,1,2023,3607,1883,1724,729,549,403,174
HKK,1,2023,1335,688,647,278,160,71,78
HKK,1,2023,3258,1656,1602,606,208,247,150
HKK,1,2023,1084,609,475,273,268,224,55
HKK,1,2023,2840,1420,1420,533,290,392,146
PAK,1,2023,2405,1154,1251,608,119,368,133
PAK,1,2023,3476,2017,1459,709,509,534,163
PAK,1,2023,2488,1199,1289,522,298,207,129
PAK,1,2023,2394,1208,1186,568,444,562,94
VYS,1,2023,1938,1034,904,345,144,126,105
VYS,1,2023,2595,1242,1353,612,348,294,144
VYS,1,2023,950,525,425,273,124,146,44
VYS,1,2023,3032,1517,1515,541,99,138,164
VYS,1,2023,2826,1338,1488,522,176,150,128
JHM,1,2023,2650,1357,1293,403,213,173,135
JHM,1,2023,13529,7308,6221,1731,1266,1592,594
JHM,1,2023,4707,2485,2222,765,478,598,216
JHM,1,2023,3148,1530,1618,612,240,252,144
JHM,1,2023,6127,2906,3221,1001,285,307,313
JHM,1,2023,1807,937,870,322,215,221,98
JHM,1,2023,4983,2453,2530,1057,270,128,263
OLK,1,2023,1594,753,841,299,55,46,65
OLK,1,2023,5352,2583,2769,1157,552,334,276
OLK,1,2023,2024,1157,867,464,181,248,74
OLK,1,2023,3899,2056,1843,612,297,331,209
OLK,1,2023,3263,1548,1715,655,242,248,151
ZLK,1,2023,2288,1176,1112,479,204,235,106
ZLK,1,2023,3156,1632,1524,591,128,207,166
ZLK,1,2023,3645,1664,1981,639,299,327,153
ZLK,1,2023,3023,1522,1501,719,348,443,148
MSK,1,2023,4335,2161,2174,654,102,177,171
MSK,1,2023,5255,2475,2780,936,246,271,227
MSK,1,2023,13838,6578,7260,1464,229,264,431
MSK,1,2023,3349,1643,1706,634,327,407,127
MSK,1,2023,3982,1862,2120,779,277,298,227
MSK,1,2023,12060,6346,5714,1784,648,816,632
PHA,2,2023,28419,16135,12284,3779,3135,976,756
STC,2,2023,1483,824,659,246,207,184,59
STC,2,2023,2520,1331,1189,306,150,113,130
STC,2,2023,5440,2966,2474,585,448,266,254
STC,2,2023,3187,1814,1373,436,378,177,154
STC,2,2023,2011,1087,924,272,136,104,83
STC,2,2023,3639,2066,1573,380,135,55,152
STC,2,2023,2290,1381,909,313,389,484,87
STC,2,2023,3062,1665,1397,383,143,77,163
STC,2,2023,2050,1215,835,352,426,344,73
STC,2,2023,1835,1044,791,313,234,80,73
STC,2,2023,3668,1826,1842,459,174,122,167
STC,2,2023,1208,675,533,176,145,77,62
JHC,2,2023,3619,1989,1630,585,447,334,182
JHC,2,2023,2071,1020,1051,236,178,637,80
JHC,2,2023,1919,937,982,270,149,143,79
JHC,2,2023,1427,808,619,187,192,151,80
JHC,2,2023,1199,559,640,176,47,80,54
JHC,2,2023,1679,856,823,194,130,117,64
JHC,2,2023,2300,1138,1162,295,192,189,123
PLK,2,2023,1084,558,526,117,105,136,48
PLK,2,2023,1957,935,1022,238,113,104,88
PLK,2,2023,3914,2250,1664,661,539,730,168
PLK,2,2023,1007,537,470,159,75,83,52
PLK,2,2023,1869,961,908,209,131,179,84
PLK,2,2023,1206,683,523,132,81,37,37
PLK,2,2023,1322,681,641,168,124,181,51
KVK,2,2023,2076,1148,928,276,308,231,77
KVK,2,2023,3600,1961,1639,378,201,344,145
KVK,2,2023,3038,1626,1412,364,95,74,180
ULK,2,2023,4912,2636,2276,489,154,93,259
ULK,2,2023,5534,3117,2417,649,227,171,266
ULK,2,2023,3247,1778,1469,431,119,154,176
ULK,2,2023,3794,2049,1745,393,307,365,189
ULK,2,2023,5282,3116,2166,606,83,115,275
ULK,2,2023,4381,2509,1872,589,130,208,245
ULK,2,2023,4896,2672,2224,496,210,146,224
LBK,2,2023,2606,1436,1170,358,204,209,132
LBK,2,2023,2643,1527,1116,302,73,130,143
LBK,2,2023,5313,2890,2423,672,587,766,207
LBK,2,2023,2115,1037,1078,247,102,136,103
HKK,2,2023,3664,1891,1773,530,566,544,181
HKK,2,2023,1298,664,634,183,174,147,68
HKK,2,2023,3295,1681,1614,374,116,164,144
HKK,2,2023,1120,634,486,197,158,100,56
HKK,2,2023,2869,1431,1438,351,209,177,130
PAK,2,2023,2392,1171,1221,326,123,191,126
PAK,2,2023,3545,2062,1483,576,331,409,158
PAK,2,2023,2491,1197,1294,277,194,178,127
PAK,2,2023,2348,1215,1133,301,289,314,101
VYS,2,2023,1920,1042,878,234,132,130,100
VYS,2,2023,2553,1230,1323,325,328,424,145
VYS,2,2023,932,523,409,162,193,148,40
VYS,2,2023,2986,1492,1494,269,110,120,152
VYS,2,2023,2791,1326,1465,304,125,84,137
JHM,2,2023,2603,1326,1277,253,134,108,136
JHM,2,2023,13628,7391,6237,1415,1358,822,631
JHM,2,2023,4645,2432,2213,536,373,365,207
JHM,2,2023,3099,1538,1561,346,207,509,139
JHM,2,2023,6078,2897,3181,517,243,202,315
JHM,2,2023,1768,931,837,204,112,105,95
JHM,2,2023,4942,2468,2474,515,126,165,265
OLK,2,2023,1525,714,811,141,69,41,46
OLK,2,2023,5365,2590,2775,764,465,588,292
OLK,2,2023,2002,1145,857,294,110,142,83
OLK,2,2023,3967,2094,1873,484,169,127,198
OLK,2,2023,3245,1553,1692,398,229,225,154
ZLK,2,2023,2217,1135,1082,271,134,149,95
ZLK,2,2023,3117,1612,1505,375,164,136,154
ZLK,2,2023,3626,1649,1977,400,236,318,137
ZLK,2,2023,2998,1514,1484,487,276,335,153
MSK,2,2023,4295,2125,2170,348,128,116,174
MSK,2,2023,5167,2422,2745,615,227,291,224
MSK,2,2023,13795,6610,7185,1124,285,148,402
MSK,2,2023,3383,1653,1730,453,372,434,131
MSK,2,2023,3939,1836,2103,475,255,179,226
MSK,2,2023,12078,6321,5757,1421,548,778,617
PHA,3,2023,28041,15908,12133,3808,3545,2169,760
STC,3,2023,1433,820,613,273,288,294,64
STC,3,2023,2464,1303,1161,279,219,141,136
STC,3,2023,5342,2921,2421,536,316,166,245
STC,3,2023,3096,1794,1302,437,262,300,141
STC,3,2023,1890,1048,842,212,246,282,86
STC,3,2023,3581,2013,1568,435,305,119,155
STC,3,2023,2234,1364,870,296,383,71,84
STC,3,2023,2998,1661,1337,347,379,381,167
STC,3,2023,2025,1205,820,343,478,367,94
STC,3,2023,1792,1012,780,306,612,83,73
STC,3,2023,3497,1799,1698,391,166,77,155
STC,3,2023,1167,678,489,163,132,190,61
JHC,3,2023,3500,1971,1529,599,450,770,186
JHC,3,2023,1873,975,898,217,191,488,78
JHC,3,2023,1632,876,756,204,138,172,71
JHC,3,2023,1320,766,554,223,228,150,69
JHC,3,2023,1082,534,548,141,104,112,52
JHC,3,2023,1597,837,760,222,150,228,66
JHC,3,2023,2151,1090,1061,291,149,159,125
PLK,3,2023,1013,543,470,156,122,152,53
PLK,3,2023,1762,914,848,236,130,266,77
PLK,3,2023,3803,2181,1622,647,794,490,172
PLK,3,2023,959,533,426,177,184,473,57
PLK,3,2023,1762,947,815,228,87,96,81
PLK,3,2023,1191,666,525,161,161,95,39
PLK,3,2023,1239,658,581,185,206,450,50
KVK,3,2023,2047,1162,885,338,559,331,84
KVK,3,2023,3498,1908,1590,425,276,274,142
KVK,3,2023,3005,1626,1379,397,91,175,172
ULK,3,2023,4765,2583,2182,510,133,90,252
ULK,3,2023,5430,3105,2325,558,210,208,253
ULK,3,2023,3171,1749,1422,426,201,227,164
ULK,3,2023,3744,2050,1694,379,199,242,186
ULK,3,2023,5319,3126,2193,639,144,179,275
ULK,3,2023,4274,2483,1791,548,179,215,226
ULK,3,2023,4853,2650,2203,536,228,153,220
LBK,3,2023,2469,1418,1051,339,219,267,131
LBK,3,2023,2624,1511,1113,320,112,127,144
LBK,3,2023,5204,2833,2371,633,504,676,206
LBK,3,2023,2016,1019,997,224,122,194,97
HKK,3,2023,3537,1862,1675,488,462,347,184
HKK,3,2023,1217,635,582,196,153,150,71
HKK,3,2023,3139,1655,1484,364,143,225,128
HKK,3,2023,1080,608,472,174,148,216,42
HKK,3,2023,2907,1484,1423,399,217,191,138
PAK,3,2023,2154,1131,1023,325,158,170,118
PAK,3,2023,3524,2104,1420,600,364,382,162
PAK,3,2023,2358,1163,1195,283,249,231,130
PAK,3,2023,2294,1214,1080,382,270,396,118
VYS,3,2023,1780,995,785,196,109,169,92
VYS,3,2023,2360,1168,1192,334,406,368,127
VYS,3,2023,879,497,382,176,118,215,42
VYS,3,2023,2783,1448,1335,271,100,88,149
VYS,3,2023,2656,1303,1353,315,181,221,127
JHM,3,2023,2541,1290,1251,280,247,198,139
JHM,3,2023,13687,7432,6255,1523,1406,1067,636
JHM,3,2023,4512,2414,2098,550,534,529,225
JHM,3,2023,2832,1427,1405,349,224,276,140
JHM,3,2023,5776,2868,2908,551,393,375,297
JHM,3,2023,1683,914,769,220,157,117,93
JHM,3,2023,4500,2385,2115,439,182,133,236
OLK,3,2023,1426,695,731,168,51,63,48
OLK,3,2023,5129,2566,2563,782,397,447,289
OLK,3,2023,1890,1094,796,304,180,102,82
OLK,3,2023,3762,2015,1747,449,296,169,193
OLK,3,2023,3114,1517,1597,383,202,235,160
ZLK,3,2023,2108,1116,992,316,180,186,99
ZLK,3,2023,2967,1586,1381,393,206,226,148
ZLK,3,2023,3499,1626,1873,404,352,286,150
ZLK,3,2023,2792,1413,1379,466,322,429,139
MSK,3,2023,4129,2115,2014,356,190,217,164
MSK,3,2023,5011,2370,2641,669,354,315,202
MSK,3,2023,13736,6606,7130,1159,201,243,396
MSK,3,2023,3307,1620,1687,444,433,386,129
MSK,3,2023,3733,1823,1910,435,362,465,193
MSK,3,2023,11813,6236,5577,1433,468,657,608
PHA,4,2023,27810,15752,12058,3385,2705,1763,726
STC,4,2023,1312,757,555,228,159,215,58
STC,4,2023,2391,1285,1106,242,126,173,132
STC,4,2023,5222,2893,2329,505,177,341,245
STC,4,2023,2938,1728,1210,369,305,244,133
STC,4,2023,1735,983,752,223,81,124,87
STC,4,2023,3447,1957,1490,352,145,162,157
STC,4,2023,2182,1337,845,265,226,708,76
STC,4,2023,2903,1647,1256,320,129,185,165
STC,4,2023,2001,1187,814,333,494,468,89
STC,4,2023,1786,1037,749,258,520,401,69
STC,4,2023,3321,1764,1557,413,210,119,147
STC,4,2023,1109,654,455,154,305,133,61
JHC,4,2023,3370,1934,1436,488,391,426,180
JHC,4,2023,1706,925,781,204,87,138,71
JHC,4,2023,1315,767,548,190,136,248,63
JHC,4,2023,1169,700,469,169,99,110,56
JHC,4,2023,976,523,453,127,78,75,52
JHC,4,2023,1430,805,625,200,122,130,64
JHC,4,2023,2050,1088,962,314,119,110,126
PLK,4,2023,954,543,411,118,176,70,45
PLK,4,2023,1560,863,697,258,115,102,79
PLK,4,2023,3704,2159,1545,592,481,472,180
PLK,4,2023,914,520,394,135,146,106,50
PLK,4,2023,1689,930,759,218,45,26,83
PLK,4,2023,1125,644,481,123,44,43,36
PLK,4,2023,1170,647,523,153,177,261,46
KVK,4,2023,1976,1140,836,291,238,251,82
KVK,4,2023,3420,1882,1538,388,292,283,147
KVK,4,2023,2925,1592,1333,344,80,78,163
ULK,4,2023,4477,2455,2022,453,122,93,238
ULK,4,2023,5403,3105,2298,565,231,421,231
ULK,4,2023,2910,1645,1265,425,245,211,162
ULK,4,2023,3514,1959,1555,349,154,222,175
ULK,4,2023,5232,3083,2149,472,123,116,279
ULK,4,2023,4196,2456,1740,474,118,140,216
ULK,4,2023,4770,2581,2189,488,176,121,221
LBK,4,2023,2324,1326,998,303,211,176,124
LBK,4,2023,2600,1492,1108,313,100,72,132
LBK,4,2023,5072,2796,2276,677,355,445,204
LBK,4,2023,1897,976,921,285,111,101,101
HKK,4,2023,3440,1869,1571,485,349,558,173
HKK,4,2023,1115,610,505,205,140,88,59
HKK,4,2023,2958,1622,1336,369,93,151,123
HKK,4,2023,1005,573,432,180,104,223,39
HKK,4,2023,2773,1467,1306,372,145,170,127
PAK,4,2023,1865,1086,779,302,101,204,112
PAK,4,2023,3393,2030,1363,561,330,319,156
PAK,4,2023,2064,1067,997,259,185,188,125
PAK,4,2023,2220,1230,990,385,226,291,119
VYS,4,2023,1658,968,690,197,134,136,84
VYS,4,2023,2130,1136,994,311,248,262,122
VYS,4,2023,793,467,326,141,82,111,42
VYS,4,2023,2457,1346,1111,285,69,143,153
VYS,4,2023,2430,1245,1185,291,126,207,127
JHM,4,2023,2459,1241,1218,233,149,185,136
JHM,4,2023,13581,7396,6185,1334,1002,903,628
JHM,4,2023,4403,2363,2040,572,329,278,229
JHM,4,2023,2449,1286,1163,329,234,180,128
JHM,4,2023,5423,2749,2674,485,272,231,287
JHM,4,2023,1632,906,726,238,202,199,98
JHM,4,2023,3972,2179,1793,450,144,192,214
OLK,4,2023,1247,640,607,176,65,49,49
OLK,4,2023,4899,2526,2373,732,359,440,288
OLK,4,2023,1778,1052,726,256,161,158,77
OLK,4,2023,3625,1966,1659,389,171,162,174
OLK,4,2023,2871,1467,1404,378,140,180,152
ZLK,4,2023,1963,1066,897,300,161,189,94
ZLK,4,2023,2829,1580,1249,405,154,290,147
ZLK,4,2023,3247,1542,1705,350,369,206,135
ZLK,4,2023,2594,1356,1238,448,287,350,134
MSK,4,2023,3793,2053,1740,345,117,115,160
MSK,4,2023,4721,2300,2421,575,206,188,186
MSK,4,2023,13613,6590,7023,1069,258,264,399
MSK,4,2023,3077,1572,1505,399,351,0,122
MSK,4,2023,3485,1750,1735,447,210,219,186
MSK,4,2023,11716,6251,5465,1388,501,411,579
PHA,5,2023,27469,15548,11921,3466,3734,2942,697
STC,5,2023,1238,735,503,249,218,154,53
STC,5,2023,2320,1271,1049,242,152,97,123
STC,5,2023,5204,2859,2345,576,291,156,245
STC,5,2023,2879,1720,1159,457,246,288,118
STC,5,2023,1650,956,694,224,150,517,92
STC,5,2023,3316,1912,1404,381,165,141,148
STC,5,2023,2123,1314,809,261,636,200,68
STC,5,2023,2844,1628,1216,304,217,134,158
STC,5,2023,1985,1174,811,330,529,486,80
STC,5,2023,1714,990,724,260,261,581,66
STC,5,2023,3181,1726,1455,368,150,183,141
STC,5,2023,1029,618,411,157,363,353,60
JHC,5,2023,3209,1863,1346,508,411,551,148
JHC,5,2023,1582,888,694,221,177,275,66
JHC,5,2023,1187,688,499,215,150,119,61
JHC,5,2023,1107,657,450,216,178,200,55
JHC,5,2023,909,510,399,134,66,95,41
JHC,5,2023,1350,789,561,184,142,106,63
JHC,5,2023,1981,1094,887,317,158,222,113
PLK,5,2023,941,547,394,142,114,74,45
PLK,5,2023,1456,824,632,238,162,175,80
PLK,5,2023,3618,2127,1491,627,1163,804,173
PLK,5,2023,870,509,361,136,159,158,50
PLK,5,2023,1634,912,722,220,294,159,76
PLK,5,2023,1076,633,443,125,50,25,32
PLK,5,2023,1136,619,517,164,311,171,50
KVK,5,2023,1926,1119,807,332,417,262,81
KVK,5,2023,3359,1851,1508,410,222,315,131
KVK,5,2023,2817,1557,1260,311,99,145,161
ULK,5,2023,4283,2378,1905,492,134,180,232
ULK,5,2023,5271,3060,2211,548,330,321,228
ULK,5,2023,2776,1578,1198,416,193,176,151
ULK,5,2023,3447,1931,1516,348,204,194,167
ULK,5,2023,5194,3072,2122,577,184,124,278
ULK,5,2023,4155,2460,1695,520,162,193,206
ULK,5,2023,4653,2524,2129,401,171,127,206
LBK,5,2023,2250,1275,975,361,270,191,133
LBK,5,2023,2519,1450,1069,293,113,105,133
LBK,5,2023,4937,2768,2169,641,423,554,206
LBK,5,2023,1767,965,802,219,124,120,98
HKK,5,2023,3328,1824,1504,467,594,480,170
HKK,5,2023,1083,607,476,217,223,194,62
HKK,5,2023,2784,1557,1227,346,211,134,115
HKK,5,2023,996,577,419,184,192,151,31
HKK,5,2023,2651,1421,1230,341,370,478,130
PAK,5,2023,1729,1064,665,285,112,136,105
PAK,5,2023,3310,1982,1328,545,410,332,148
PAK,5,2023,1954,1022,932,305,258,406,108
PAK,5,2023,2201,1249,952,378,477,291,122
VYS,5,2023,1552,929,623,199,198,108,78
VYS,5,2023,2015,1115,900,323,354,434,121
VYS,5,2023,759,456,303,182,102,201,38
VYS,5,2023,2330,1323,1007,290,112,81,141
VYS,5,2023,2317,1217,1100,329,170,109,108
JHM,5,2023,2384,1224,1160,245,140,191,127
JHM,5,2023,13526,7358,6168,1426,1261,1224,631
JHM,5,2023,4368,2357,2011,576,532,522,230
JHM,5,2023,2285,1223,1062,337,303,284,117
JHM,5,2023,5180,2688,2492,545,376,434,283
JHM,5,2023,1568,877,691,204,200,191,105
JHM,5,2023,3695,2050,1645,439,160,219,191
OLK,5,2023,1113,602,511,142,79,65,50
OLK,5,2023,4739,2496,2243,776,494,476,276
OLK,5,2023,1672,992,680,281,122,215,73
OLK,5,2023,3493,1895,1598,380,240,251,172
OLK,5,2023,2701,1405,1296,356,161,241,140
ZLK,5,2023,1913,1047,866,319,165,176,96
ZLK,5,2023,2696,1509,1187,369,177,178,137
ZLK,5,2023,3035,1523,1512,383,341,609,138
ZLK,5,2023,2530,1316,1214,448,298,518,122
MSK,5,2023,3593,1999,1594,347,154,120,149
MSK,5,2023,4634,2267,2367,712,222,232,194
MSK,5,2023,13509,6511,6998,1158,247,193,401
MSK,5,2023,2951,1526,1425,436,612,459,123
MSK,5,2023,3373,1702,1671,439,247,207,191
MSK,5,2023,11564,6210,5354,1404,645,577,563
PHA,6,2023,27164,15385,11779,3555,3551,1714,610
STC,6,2023,1202,718,484,220,196,186,50
STC,6,2023,2266,1258,1008,234,144,329,103
STC,6,2023,5141,2869,2272,486,359,329,207
STC,6,2023,2861,1736,1125,408,209,235,96
STC,6,2023,1661,960,701,219,113,139,80
STC,6,2023,3305,1905,1400,387,180,114,114
STC,6,2023,2116,1306,810,282,599,470,76
STC,6,2023,2833,1619,1214,338,180,271,136
STC,6,2023,1951,1146,805,295,560,564,75
STC,6,2023,1730,1017,713,273,389,192,55
STC,6,2023,3105,1696,1409,371,190,92,118
STC,6,2023,1029,621,408,141,139,94,50
JHC,6,2023,3090,1788,1302,531,421,416,126
JHC,6,2023,1534,876,658,220,138,70,58
JHC,6,2023,1117,657,460,195,98,278,40
JHC,6,2023,1106,678,428,215,160,109,44
JHC,6,2023,874,492,382,122,108,225,32
JHC,6,2023,1318,769,549,198,125,93,50
JHC,6,2023,1907,1059,848,260,159,130,92
PLK,6,2023,928,563,365,123,110,131,36
PLK,6,2023,1432,788,644,253,130,174,69
PLK,6,2023,3603,2089,1514,618,646,690,146
PLK,6,2023,839,478,361,130,193,119,35
PLK,6,2023,1591,892,699,186,67,117,58
PLK,6,2023,1071,628,443,136,58,56,30
PLK,6,2023,1142,624,518,160,296,204,47
KVK,6,2023,1883,1106,777,283,270,372,63
KVK,6,2023,3238,1777,1461,396,186,255,113
KVK,6,2023,2748,1535,1213,316,94,117,140
ULK,6,2023,4191,2348,1843,471,181,212,188
ULK,6,2023,5245,3066,2179,489,297,557,194
ULK,6,2023,2688,1543,1145,363,177,231,114
ULK,6,2023,3458,1955,1503,344,196,308,145
ULK,6,2023,5130,3054,2076,487,94,94,226
ULK,6,2023,4047,2428,1619,438,174,151,164
ULK,6,2023,4704,2550,2154,549,174,149,165
LBK,6,2023,2197,1231,966,317,229,244,110
LBK,6,2023,2485,1450,1035,315,74,116,116
LBK,6,2023,4828,2750,2078,616,405,567,173
LBK,6,2023,1742,995,747,244,118,97,76
HKK,6,2023,3335,1874,1461,488,389,503,142
HKK,6,2023,1038,583,455,179,116,154,49
HKK,6,2023,2691,1526,1165,325,191,216,91
HKK,6,2023,970,569,401,161,135,182,35
HKK,6,2023,2607,1431,1176,372,213,249,114
PAK,6,2023,1642,1016,626,279,129,97,79
PAK,6,2023,3279,1947,1332,505,484,379,125
PAK,6,2023,1900,980,920,283,200,175,82
PAK,6,2023,2151,1231,920,348,262,283,95
VYS,6,2023,1503,909,594,184,83,122,71
VYS,6,2023,1997,1124,873,332,303,310,95
VYS,6,2023,745,451,294,153,120,98,30
VYS,6,2023,2292,1318,974,285,121,149,109
VYS,6,2023,2335,1244,1091,330,166,123,102
JHM,6,2023,2357,1214,1143,251,129,171,100
JHM,6,2023,13417,7330,6087,1413,1244,873,539
JHM,6,2023,4313,2367,1946,507,516,651,175
JHM,6,2023,2263,1230,1033,360,341,242,87
JHM,6,2023,5023,2587,2436,476,300,480,209
JHM,6,2023,1575,876,699,214,77,126,72
JHM,6,2023,3522,1952,1570,409,223,178,130
OLK,6,2023,1054,569,485,147,36,62,40
OLK,6,2023,4709,2536,2173,773,424,315,231
OLK,6,2023,1602,959,643,270,154,81,60
OLK,6,2023,3391,1873,1518,371,186,171,135
OLK,6,2023,2694,1418,1276,367,268,248,104
ZLK,6,2023,1880,1030,850,283,171,170,79
ZLK,6,2023,2553,1455,1098,317,181,226,110
ZLK,6,2023,2994,1511,1483,379,256,363,117
ZLK,6,2023,2522,1314,1208,443,298,525,85
MSK,6,2023,3504,1974,1530,327,159,182,128
MSK,6,2023,4611,2282,2329,650,325,233,171
MSK,6,2023,13202,6399,6803,1037,219,239,347
MSK,6,2023,2883,1513,1370,396,303,356,97
MSK,6,2023,3322,1701,1621,455,240,159,166
MSK,6,2023,11416,6153,5263,1315,494,543,491
PHA,7,2023,28176,16146,12030,3920,3154,1193,637
STC,7,2023,1279,773,506,254,181,125,41
STC,7,2023,2369,1347,1022,306,169,169,91
STC,7,2023,5251,2971,2280,565,259,425,206
STC,7,2023,2996,1836,1160,471,235,312,112
STC,7,2023,1699,995,704,252,178,147,79
STC,7,2023,3442,2012,1430,478,199,76,108
STC,7,2023,2169,1340,829,302,297,415,71
STC,7,2023,2905,1708,1197,365,112,69,135
STC,7,2023,2076,1241,835,422,604,4403,76
STC,7,2023,1838,1103,735,324,412,665,60
STC,7,2023,3236,1777,1459,441,170,161,121
STC,7,2023,1073,648,425,177,50,71,49
JHC,7,2023,3273,1936,1337,616,242,292,157
JHC,7,2023,1572,891,681,192,87,124,60
JHC,7,2023,1200,696,504,282,123,75,57
JHC,7,2023,1156,725,431,220,95,117,56
JHC,7,2023,872,492,380,142,66,140,40
JHC,7,2023,1394,821,573,247,79,74,52
JHC,7,2023,2027,1148,879,343,135,146,106
PLK,7,2023,983,600,383,167,87,90,37
PLK,7,2023,1550,862,688,306,102,125,86
PLK,7,2023,3817,2269,1548,728,631,467,146
PLK,7,2023,881,513,368,154,182,129,41
PLK,7,2023,1626,928,698,230,198,79,60
PLK,7,2023,1107,655,452,145,123,270,33
PLK,7,2023,1215,687,528,228,186,213,56
KVK,7,2023,1931,1136,795,296,238,148,56
KVK,7,2023,3286,1796,1490,406,197,232,112
KVK,7,2023,2827,1591,1236,359,126,74,133
ULK,7,2023,4219,2404,1815,520,70,112,173
ULK,7,2023,5355,3147,2208,560,194,236,200
ULK,7,2023,2811,1642,1169,492,110,214,132
ULK,7,2023,3533,2020,1513,360,138,83,145
ULK,7,2023,5292,3169,2123,554,103,54,223
ULK,7,2023,4100,2485,1615,480,408,210,164
ULK,7,2023,4747,2599,2148,464,161,282,165
LBK,7,2023,2291,1281,1010,378,215,176,105
LBK,7,2023,2540,1488,1052,332,49,62,120
LBK,7,2023,4909,2879,2030,634,416,487,168
LBK,7,2023,1819,1062,757,259,61,135,82
HKK,7,2023,3472,1984,1488,541,626,300,153
HKK,7,2023,1103,649,454,223,73,104,57
HKK,7,2023,2742,1584,1158,382,143,200,82
HKK,7,2023,1062,641,421,225,106,64,38
HKK,7,2023,2711,1521,1190,425,164,142,108
PAK,7,2023,1798,1106,692,393,112,109,85
PAK,7,2023,3429,2059,1370,596,341,284,152
PAK,7,2023,2011,1092,919,351,156,133,82
PAK,7,2023,2283,1318,965,415,227,275,93
VYS,7,2023,1594,969,625,253,59,131,80
VYS,7,2023,2147,1243,904,408,228,276,102
VYS,7,2023,815,498,317,208,57,71,42
VYS,7,2023,2392,1430,962,344,101,87,123
VYS,7,2023,2420,1309,1111,346,150,221,117
JHM,7,2023,2497,1309,1188,361,122,153,109
JHM,7,2023,13850,7676,6174,1554,1321,775,578
JHM,7,2023,4595,2611,1984,688,347,410,169
JHM,7,2023,2389,1314,1075,391,185,205,85
JHM,7,2023,5116,2671,2445,572,189,259,209
JHM,7,2023,1639,946,693,258,56,129,67
JHM,7,2023,3565,1995,1570,483,154,151,136
OLK,7,2023,1071,576,495,157,21,57,39
OLK,7,2023,4900,2666,2234,811,286,359,257
OLK,7,2023,1716,1021,695,325,49,98,53
OLK,7,2023,3465,1936,1529,419,1071,52,142
OLK,7,2023,2835,1530,1305,473,102,156,120
ZLK,7,2023,1962,1095,867,348,122,145,86
ZLK,7,2023,2725,1601,1124,491,135,123,122
ZLK,7,2023,3069,1604,1465,425,240,210,124
ZLK,7,2023,2789,1465,1324,632,259,136,113
MSK,7,2023,3565,2036,1529,397,84,98,132
MSK,7,2023,4849,2464,2385,753,138,174,179
MSK,7,2023,13355,6567,6788,1142,140,120,368
MSK,7,2023,3047,1634,1413,504,270,380,99
MSK,7,2023,3495,1813,1682,573,179,232,182
MSK,7,2023,11618,6390,5228,1438,437,459,494
PHA,8,2023,28501,16386,12115,3958,2889,1391,653
STC,8,2023,1280,764,516,278,176,140,46
STC,8,2023,2436,1381,1055,319,128,114,98
STC,8,2023,5281,3036,2245,551,318,263,230
STC,8,2023,3049,1864,1185,452,153,191,130
STC,8,2023,1713,1004,709,236,151,147,85
STC,8,2023,3486,2060,1426,459,165,111,120
STC,8,2023,2211,1363,848,297,283,322,79
STC,8,2023,2971,1754,1217,381,186,245,149
STC,8,2023,2039,1220,819,344,492,302,79
STC,8,2023,1859,1128,731,305,405,276,63
STC,8,2023,3190,1746,1444,373,163,188,136
STC,8,2023,1071,642,429,161,87,128,57
JHC,8,2023,3396,2047,1349,661,294,322,182
JHC,8,2023,1580,884,696,219,182,64,58
JHC,8,2023,1212,710,502,246,97,87,58
JHC,8,2023,1168,719,449,192,125,94,66
JHC,8,2023,864,480,384,128,72,191,36
JHC,8,2023,1395,843,552,201,168,193,64
JHC,8,2023,2050,1172,878,325,107,156,118
PLK,8,2023,987,613,374,144,95,95,49
PLK,8,2023,1533,856,677,244,136,116,93
PLK,8,2023,3879,2322,1557,668,602,576,182
PLK,8,2023,896,536,360,168,106,126,46
PLK,8,2023,1667,946,721,247,74,82,74
PLK,8,2023,1124,678,446,143,216,129,38
PLK,8,2023,1220,681,539,172,319,334,56
KVK,8,2023,1956,1162,794,299,258,148,47
KVK,8,2023,3270,1798,1472,387,167,178,122
KVK,8,2023,2799,1584,1215,331,111,85,142
ULK,8,2023,4184,2401,1783,447,96,114,182
ULK,8,2023,5381,3150,2231,567,286,350,221
ULK,8,2023,2849,1690,1159,413,118,145,133
ULK,8,2023,3510,2038,1472,337,260,116,156
ULK,8,2023,5321,3186,2135,510,144,150,244
ULK,8,2023,4071,2480,1591,497,142,205,157
ULK,8,2023,4766,2602,2164,489,185,114,185
LBK,8,2023,2305,1305,1000,340,241,228,120
LBK,8,2023,2529,1497,1032,294,58,83,124
LBK,8,2023,4957,2931,2026,666,358,463,184
LBK,8,2023,1806,1048,758,236,106,242,92
HKK,8,2023,3526,2037,1489,499,400,683,183
HKK,8,2023,1146,690,456,233,124,202,73
HKK,8,2023,2721,1579,1142,352,186,190,96
HKK,8,2023,1079,644,435,215,120,181,43
HKK,8,2023,2722,1536,1186,350,214,182,114
PAK,8,2023,1890,1173,717,379,109,129,113
PAK,8,2023,3389,2038,1351,529,558,660,162
PAK,8,2023,2077,1121,956,339,147,197,92
PAK,8,2023,2345,1347,998,395,268,260,104
VYS,8,2023,1582,960,622,212,129,109,90
VYS,8,2023,2143,1246,897,359,634,375,115
VYS,8,2023,818,501,317,182,87,96,49
VYS,8,2023,2396,1434,962,293,65,116,140
VYS,8,2023,2452,1334,1118,328,233,124,129
JHM,8,2023,2471,1319,1152,273,102,149,121
JHM,8,2023,13989,7760,6229,1532,1272,6547,615
JHM,8,2023,4672,2643,2029,654,485,438,193
JHM,8,2023,2440,1362,1078,391,227,447,102
JHM,8,2023,5137,2696,2441,549,267,308,228
JHM,8,2023,1670,970,700,249,78,109,76
JHM,8,2023,3631,2039,1592,521,178,249,147
OLK,8,2023,1079,576,503,148,33,55,45
OLK,8,2023,4982,2749,2233,783,350,382,267
OLK,8,2023,1731,1031,700,279,121,52,52
OLK,8,2023,3426,1946,1480,374,156,254,147
OLK,8,2023,2819,1524,1295,388,224,247,136
ZLK,8,2023,1992,1107,885,327,138,125,92
ZLK,8,2023,2716,1608,1108,411,186,188,135
ZLK,8,2023,3079,1601,1478,418,327,309,142
ZLK,8,2023,2726,1473,1253,482,303,275,134
MSK,8,2023,3558,2050,1508,317,86,147,138
MSK,8,2023,4961,2535,2426,737,195,263,202
MSK,8,2023,13335,6574,6761,1090,204,177,380
MSK,8,2023,3082,1642,1440,462,339,358,119
MSK,8,2023,3440,1805,1635,427,232,191,169
MSK,8,2023,11819,6537,5282,1481,398,536,498
PHA,9,2023,28039,15915,12124,4378,2813,2222,874
STC,9,2023,1294,750,544,357,62,51,80
STC,9,2023,2473,1384,1089,435,119,107,166
STC,9,2023,5234,2951,2283,760,178,168,341
STC,9,2023,3152,1888,1264,663,121,161,237
STC,9,2023,1743,1012,731,361,112,124,120
STC,9,2023,3484,2047,1437,554,107,127,221
STC,9,2023,2297,1381,916,438,448,193,154
STC,9,2023,3006,1748,1258,558,188,116,248
STC,9,2023,2011,1186,825,483,482,462,149
STC,9,2023,1867,1113,754,411,353,20,97
STC,9,2023,3238,1762,1476,634,214,115,240
STC,9,2023,1144,665,479,275,118,133,96
JHC,9,2023,3357,2001,1356,745,322,428,225
JHC,9,2023,1662,915,747,332,132,219,110
JHC,9,2023,1270,738,532,321,75,89,107
JHC,9,2023,1158,689,469,266,182,103,100
JHC,9,2023,854,466,388,190,107,172,67
JHC,9,2023,1445,845,600,340,145,109,121
JHC,9,2023,2019,1153,866,410,123,134,150
PLK,9,2023,1057,645,412,262,77,102,103
PLK,9,2023,1526,845,681,353,125,142,120
PLK,9,2023,3781,2245,1536,752,473,411,223
PLK,9,2023,909,536,373,206,243,197,82
PLK,9,2023,1639,925,714,312,195,38,122
PLK,9,2023,1152,662,490,225,104,66,75
PLK,9,2023,1258,680,578,250,256,265,84
KVK,9,2023,1983,1159,824,394,245,351,118
KVK,9,2023,3306,1818,1488,538,226,239,187
KVK,9,2023,2937,1633,1304,518,68,51,235
ULK,9,2023,4371,2495,1876,763,86,131,332
ULK,9,2023,5496,3166,2330,833,375,269,327
ULK,9,2023,2980,1721,1259,672,126,105,222
ULK,9,2023,3553,2031,1522,505,301,279,261
ULK,9,2023,5364,3146,2218,713,191,122,372
ULK,9,2023,4220,2530,1690,736,174,199,306
ULK,9,2023,4880,2639,2241,649,127,112,264
LBK,9,2023,2393,1348,1045,508,125,147,225
LBK,9,2023,2516,1463,1053,436,65,86,168
LBK,9,2023,4967,2887,2080,896,538,536,235
LBK,9,2023,1813,1003,810,367,256,271,114
HKK,9,2023,3547,1996,1551,723,332,434,278
HKK,9,2023,1178,695,483,305,100,96,108
HKK,9,2023,2700,1518,1182,548,125,151,169
HKK,9,2023,1183,700,483,351,132,146,114
HKK,9,2023,2746,1514,1232,537,144,162,207
PAK,9,2023,1891,1151,740,482,158,103,183
PAK,9,2023,3436,2054,1382,811,381,667,259
PAK,9,2023,2166,1151,1015,489,149,163,182
PAK,9,2023,2406,1343,1063,591,247,269,181
VYS,9,2023,1633,964,669,363,70,134,134
VYS,9,2023,2085,1163,922,444,458,402,165
VYS,9,2023,818,481,337,262,116,84,74
VYS,9,2023,2408,1399,1009,450,79,122,196
VYS,9,2023,2465,1296,1169,487,162,123,200
JHM,9,2023,2493,1324,1169,420,166,138,183
JHM,9,2023,13776,7587,6189,1802,997,1130,736
JHM,9,2023,4631,2578,2053,840,489,304,301
JHM,9,2023,2530,1336,1194,579,176,163,222
JHM,9,2023,5262,2696,2566,842,211,195,356
JHM,9,2023,1714,975,739,364,88,92,130
JHM,9,2023,3718,2079,1639,700,91,88,256
OLK,9,2023,1092,576,516,218,25,34,73
OLK,9,2023,5058,2734,2324,1137,384,393,422
OLK,9,2023,1779,1036,743,414,93,220,131
OLK,9,2023,3507,1964,1543,682,163,287,274
OLK,9,2023,2936,1588,1348,637,137,158,213
ZLK,9,2023,1903,1036,867,411,165,178,137
ZLK,9,2023,2728,1582,1146,582,206,171,223
ZLK,9,2023,3116,1592,1524,622,256,323,239
ZLK,9,2023,2775,1456,1319,726,239,239,212
MSK,9,2023,3673,2106,1567,563,89,115,222
MSK,9,2023,4940,2468,2472,935,195,214,331
MSK,9,2023,13434,6566,6868,1491,154,147,536
MSK,9,2023,3146,1630,1516,680,270,336,217
MSK,9,2023,3392,1718,1674,697,216,248,262
MSK,9,2023,11907,6497,5410,1794,447,298,690
PHA,10,2023,27808,15693,12115,4163,3278,3022,972
STC,10,2023,1301,736,565,318,112,124,92
STC,10,2023,2415,1355,1060,353,162,92,160
STC,10,2023,5148,2883,2265,561,167,494,350
STC,10,2023,3099,1847,1252,460,237,206,235
STC,10,2023,1776,1045,731,314,88,80,140
STC,10,2023,3554,2079,1475,552,111,105,233
STC,10,2023,2280,1381,899,356,490,129,148
STC,10,2023,2960,1689,1271,437,141,172,246
STC,10,2023,1970,1161,809,388,570,958,149
STC,10,2023,1774,1053,721,296,253,286,90
STC,10,2023,3188,1712,1476,447,144,84,231
STC,10,2023,1106,646,460,192,101,47,88
JHC,10,2023,3381,1976,1405,688,360,288,236
JHC,10,2023,1668,924,744,305,136,165,98
JHC,10,2023,1325,759,566,321,107,125,93
JHC,10,2023,1160,702,458,224,96,136,88
JHC,10,2023,828,448,380,136,105,91,62
JHC,10,2023,1481,844,637,268,149,178,127
JHC,10,2023,2016,1152,864,337,134,179,163
PLK,10,2023,1023,602,421,158,87,115,88
PLK,10,2023,1482,821,661,281,183,160,108
PLK,10,2023,3845,2251,1594,780,543,368,250
PLK,10,2023,931,540,391,208,167,64,84
PLK,10,2023,1612,922,690,270,49,119,117
PLK,10,2023,1132,642,490,147,148,96,70
PLK,10,2023,1198,668,530,177,356,364,79
KVK,10,2023,1983,1165,818,356,194,263,132
KVK,10,2023,3331,1834,1497,448,185,218,201
KVK,10,2023,2947,1623,1324,425,54,79,231
ULK,10,2023,4411,2495,1916,625,109,250,342
ULK,10,2023,5465,3145,2320,623,659,296,315
ULK,10,2023,2974,1720,1254,496,238,222,203
ULK,10,2023,3474,1990,1484,383,138,112,248
ULK,10,2023,5265,3088,2177,512,132,124,363
ULK,10,2023,4144,2471,1673,569,146,127,321
ULK,10,2023,4747,2569,2178,492,143,170,269
LBK,10,2023,2377,1343,1034,394,157,192,232
LBK,10,2023,2500,1446,1054,346,100,135,182
LBK,10,2023,4912,2838,2074,776,629,579,245
LBK,10,2023,1793,976,817,266,277,352,119
HKK,10,2023,3512,1985,1527,580,369,419,271
HKK,10,2023,1179,699,480,234,116,176,126
HKK,10,2023,2653,1483,1170,396,158,215,185
HKK,10,2023,1131,669,462,195,132,140,108
HKK,10,2023,2700,1499,1201,393,196,291,196
PAK,10,2023,1869,1111,758,383,109,179,162
PAK,10,2023,3324,1993,1331,582,424,670,248
PAK,10,2023,2191,1156,1035,358,199,259,171
PAK,10,2023,2397,1345,1052,449,252,446,185
VYS,10,2023,1582,918,664,220,101,159,119
VYS,10,2023,2041,1128,913,353,228,320,152
VYS,10,2023,840,500,340,191,87,78,67
VYS,10,2023,2376,1394,982,373,108,77,172
VYS,10,2023,2387,1272,1115,343,139,288,170
JHM,10,2023,2420,1288,1132,290,115,326,177
JHM,10,2023,13551,7486,6065,1534,839,1007,709
JHM,10,2023,4546,2513,2033,627,318,449,274
JHM,10,2023,2517,1320,1197,428,214,271,202
JHM,10,2023,5258,2684,2574,596,238,260,345
JHM,10,2023,1691,943,748,241,86,89,115
JHM,10,2023,3731,2088,1643,603,164,133,248
OLK,10,2023,1126,580,546,202,54,107,82
OLK,10,2023,5058,2684,2374,924,424,391,394
OLK,10,2023,1800,1031,769,331,114,61,125
OLK,10,2023,3454,1941,1513,433,190,172,258
OLK,10,2023,2926,1551,1375,449,146,174,196
ZLK,10,2023,1835,991,844,319,129,164,119
ZLK,10,2023,2661,1525,1136,379,132,130,186
ZLK,10,2023,3080,1558,1522,432,252,233,213
ZLK,10,2023,2738,1414,1324,520,270,204,184
MSK,10,2023,3670,2123,1547,388,100,144,212
MSK,10,2023,4851,2396,2455,683,154,203,289
MSK,10,2023,13296,6458,6838,1182,200,185,522
MSK,10,2023,3122,1610,1512,485,384,359,201
MSK,10,2023,3444,1750,1694,577,197,278,264
MSK,10,2023,11900,6458,5442,1551,414,463,677
PHA,11,2023,27298,15377,11921,3694,2963,4620,935
STC,11,2023,1321,745,576,287,166,100,74
STC,11,2023,2402,1340,1062,319,257,94,146
STC,11,2023,4991,2747,2244,539,232,224,310
STC,11,2023,3057,1817,1240,441,179,186,213
STC,11,2023,1787,1046,741,259,81,114,134
STC,11,2023,3495,2041,1454,423,150,49,211
STC,11,2023,2278,1363,915,307,455,41,135
STC,11,2023,3014,1713,1301,432,222,189,221
STC,11,2023,1946,1111,835,344,605,245,128
STC,11,2023,1728,1002,726,307,313,84,77
STC,11,2023,3209,1677,1532,454,150,360,213
STC,11,2023,1099,637,462,185,87,69,83
JHC,11,2023,3432,1960,1472,616,400,307,227
JHC,11,2023,1714,920,794,289,126,93,91
JHC,11,2023,1457,847,610,343,87,107,97
JHC,11,2023,1235,738,497,266,129,155,90
JHC,11,2023,863,456,407,186,178,60,55
JHC,11,2023,1581,895,686,299,89,110,117
JHC,11,2023,2064,1154,910,380,129,167,147
PLK,11,2023,1068,623,445,194,96,75,82
PLK,11,2023,1589,883,706,395,113,457,99
PLK,11,2023,3797,2179,1618,700,451,555,218
PLK,11,2023,972,552,420,199,85,36,84
PLK,11,2023,1649,933,716,264,61,195,102
PLK,11,2023,1140,639,501,172,63,68,63
PLK,11,2023,1223,659,564,217,165,132,77
KVK,11,2023,2082,1204,878,375,299,342,120
KVK,11,2023,3418,1867,1551,464,202,229,189
KVK,11,2023,3065,1646,1419,441,67,49,210
ULK,11,2023,4620,2585,2035,717,108,117,324
ULK,11,2023,5421,3134,2287,583,220,323,285
ULK,11,2023,2981,1706,1275,445,125,140,194
ULK,11,2023,3496,1987,1509,454,130,209,228
ULK,11,2023,5310,3099,2211,572,190,126,331
ULK,11,2023,4083,2427,1656,544,155,167,285
ULK,11,2023,4710,2548,2162,509,158,143,264
LBK,11,2023,2441,1358,1083,419,151,136,222
LBK,11,2023,2535,1453,1082,352,96,161,172
LBK,11,2023,4908,2821,2087,680,336,378,228
LBK,11,2023,1843,965,878,312,121,163,107
HKK,11,2023,3535,1947,1588,521,292,277,249
HKK,11,2023,1178,675,503,238,143,133,103
HKK,11,2023,2725,1494,1231,452,194,240,181
HKK,11,2023,1150,655,495,234,148,160,100
HKK,11,2023,2748,1514,1234,435,148,153,177
PAK,11,2023,1990,1150,840,451,70,123,146
PAK,11,2023,3291,1959,1332,547,413,379,217
PAK,11,2023,2255,1138,1117,394,143,143,150
PAK,11,2023,2400,1333,1067,410,185,473,153
VYS,11,2023,1642,944,698,276,86,130,103
VYS,11,2023,2073,1120,953,388,316,218,131
VYS,11,2023,846,489,357,183,62,50,59
VYS,11,2023,2461,1423,1038,424,118,67,151
VYS,11,2023,2455,1267,1188,369,110,142,159
JHM,11,2023,2466,1297,1169,364,115,173,142
JHM,11,2023,13466,7383,6083,1497,687,682,653
JHM,11,2023,4488,2448,2040,601,388,365,259
JHM,11,2023,2636,1405,1231,524,199,156,166
JHM,11,2023,5380,2692,2688,684,188,217,309
JHM,11,2023,1714,934,780,271,126,126,95
JHM,11,2023,3979,2230,1749,707,93,168,240
OLK,11,2023,1231,617,614,263,23,44,70
OLK,11,2023,5114,2687,2427,870,396,368,353
OLK,11,2023,1868,1064,804,342,65,72,107
OLK,11,2023,3431,1888,1543,449,135,177,245
OLK,11,2023,3074,1589,1485,561,127,111,174
ZLK,11,2023,1890,988,902,390,155,201,107
ZLK,11,2023,2716,1517,1199,444,136,182,165
ZLK,11,2023,3129,1560,1569,476,272,316,177
ZLK,11,2023,2789,1397,1392,526,299,250,148
MSK,11,2023,3900,2248,1652,554,68,100,207
MSK,11,2023,4838,2345,2493,689,147,180,243
MSK,11,2023,13261,6416,6845,1226,153,165,494
MSK,11,2023,3233,1638,1595,593,350,402,175
MSK,11,2023,3546,1763,1783,581,214,222,255
MSK,11,2023,12006,6448,5558,1425,275,277,651
